filename,unique_id,Total,chromosome,ecDNA,MIA_total,TP,TP_partial,FN,FP,ref_total
NCIH2170_TOTAL_HER2_R1_G2_24_10_106_Merge(RGB).tif,NCIH2170_TOTAL_HER2_R1_G2_24_10_106_Merge(RGB),311,0,311,40,18,19,274,3,311
NCIH2170_TOTAL_HER2_R1_G2_24_10_84_Merge(RGB).tif,NCIH2170_TOTAL_HER2_R1_G2_24_10_84_Merge(RGB),115,4,111,25,17,6,92,2,115
NCIH2170_HIGH_HER2_R1_G2_24_10_94_Merge(RGB).tif,NCIH2170_HIGH_HER2_R1_G2_24_10_94_Merge(RGB),440,46,394,259,114,116,210,29,440
NCIH2170_LOW_HER2_R1_G0_2501_117_Merge.tif (RGB).tif,NCIH2170_LOW_HER2_R1_G0_2501_117,158,1,157,33,9,20,129,4,158
NCIH2170_LOW_HER2_R1_G1_2404_15_Merge(RGB).tif,NCIH2170_LOW_HER2_R1_G1_2404_15_Merge(RGB),85,0,85,29,8,17,60,4,85
NCIH2170_LOW_HER2_R1_G2_24_10_103_Merge(RGB).tif,NCIH2170_LOW_HER2_R1_G2_24_10_103_Merge(RGB),45,8,37,33,14,7,24,12,45
NCIH2170_LOW_HER2_R1_G2_24_10_96_Merge(RGB).tif,NCIH2170_LOW_HER2_R1_G2_24_10_96_Merge(RGB),172,6,166,63,27,27,118,9,172
NCIH2170_TOTAL_HER2_R1_G2_24_10_117_Merge(RGB).tif,NCIH2170_TOTAL_HER2_R1_G2_24_10_117_Merge(RGB),307,31,276,134,32,67,208,35,307
NCIH2170_TOTAL_HER2_R1_G1_2404_27_Merge(RGB).tif,NCIH2170_TOTAL_HER2_R1_G1_2404_27_Merge(RGB),411,0,411,355,168,76,167,111,411
NCIH2170_HIGH_HER2_R1_G0_2501_70_Merge.tif (RGB).tif,NCIH2170_HIGH_HER2_R1_G0_2501_70,177,14,163,37,13,20,144,4,177
NCIH2170_LOW_HER2_R1_G1_2404_1_Merge(RGB).tif,NCIH2170_LOW_HER2_R1_G1_2404_1_Merge(RGB),251,4,247,74,37,26,188,11,251
NCIH2170_LOW_HER2_R1_G2_24_10_8_Merge(RGB).tif,NCIH2170_LOW_HER2_R1_G2_24_10_8_Merge(RGB),188,0,188,101,55,31,102,15,188
NCIH2170_HIGH_HER2_R1_G2_24_10_36B_Merge(RGB).tif,NCIH2170_HIGH_HER2_R1_G2_24_10_36B_Merge(RGB),218,0,218,89,32,31,155,26,218
NCIH2170_LOW_HER2_R1_G2_24_10_49_Merge(RGB).tif,NCIH2170_LOW_HER2_R1_G2_24_10_49_Merge(RGB),122,1,121,61,43,14,65,4,122
NCIH2170_TOTAL_HER2_R1_G2_24_10_65_Merge(RGB).tif,NCIH2170_TOTAL_HER2_R1_G2_24_10_65_Merge(RGB),404,1,403,213,127,59,218,27,404
NCIH2170_LOW_HER2_R1_G0_2501_114_Merge.tif (RGB).tif,NCIH2170_LOW_HER2_R1_G0_2501_114,105,2,103,65,26,17,62,22,105
NCIH2170_HIGH_HER2_R1_G1_2404_S2_11_Merge(RGB).tif,NCIH2170_HIGH_HER2_R1_G1_2404_S2_11_Merge(RGB),174,0,174,160,102,20,52,38,174
NCIH2170_TOTAL_HER2_R1_G1_2404_81_Merge(RGB).tif,NCIH2170_TOTAL_HER2_R1_G1_2404_81_Merge(RGB),186,0,186,132,59,36,91,37,186
NCIH2170_TOTAL_HER2_R1_G0_2501_128_Merge.tif (RGB).tif,NCIH2170_TOTAL_HER2_R1_G0_2501_128,211,0,211,102,35,45,131,22,211
NCIH2170_HIGH_HER2_R1_G1_2404_S2_10_Merge(RGB).tif,NCIH2170_HIGH_HER2_R1_G1_2404_S2_10_Merge(RGB),348,11,337,246,166,54,128,26,348
NCIH2170_LOW_HER2_R1_G2_24_10_59_Merge(RGB).tif,NCIH2170_LOW_HER2_R1_G2_24_10_59_Merge(RGB),172,9,163,104,50,32,90,22,172
NCIH2170_TOTAL_HER2_R1_G1_2404_75_Merge(RGB).tif,NCIH2170_TOTAL_HER2_R1_G1_2404_75_Merge(RGB),182,17,165,103,51,29,102,23,182
NCIH2170_LOW_HER2_R1_G0_2501_53_Merge.tif (RGB).tif,NCIH2170_LOW_HER2_R1_G0_2501_53,272,4,268,56,20,36,216,0,272
NCIH2170_HIGH_HER2_R1_G0_2501_85_Merge.tif (RGB).tif,NCIH2170_HIGH_HER2_R1_G0_2501_85,100,2,98,32,16,10,74,6,100
NCIH2170_TOTAL_HER2_R1_G2_24_10_56_Merge(RGB).tif,NCIH2170_TOTAL_HER2_R1_G2_24_10_56_Merge(RGB),268,1,267,80,16,50,202,14,268
NCIH2170_TOTAL_HER2_R1_G2_24_10_85_Merge(RGB).tif,NCIH2170_TOTAL_HER2_R1_G2_24_10_85_Merge(RGB),282,0,282,118,65,42,175,11,282
NCIH2170_LOW_HER2_R1_G1_2404_11_Merge(RGB).tif,NCIH2170_LOW_HER2_R1_G1_2404_11_Merge(RGB),72,6,66,72,29,16,27,27,72
NCIH2170_TOTAL_HER2_R1_G1_2404_6_Merge(RGB).tif,NCIH2170_TOTAL_HER2_R1_G1_2404_6_Merge(RGB),359,27,332,114,57,49,253,8,359
NCIH2170_TOTAL_HER2_R1_G2_24_10_71_Merge(RGB).tif,NCIH2170_TOTAL_HER2_R1_G2_24_10_71_Merge(RGB),367,0,367,183,79,63,225,41,367
NCIH2170_LOW_HER2_R1_G2_24_10_119_Merge(RGB).tif,NCIH2170_LOW_HER2_R1_G2_24_10_119_Merge(RGB),152,12,140,36,13,17,122,6,152
NCIH2170_TOTAL_HER2_R1_G2_24_10_29_Merge(RGB).tif,NCIH2170_TOTAL_HER2_R1_G2_24_10_29_Merge(RGB),41,3,38,23,8,7,26,8,41
NCIH2170_LOW_HER2_R1_G0_2501_93_Merge.tif (RGB).tif,NCIH2170_LOW_HER2_R1_G0_2501_93,56,7,49,27,5,14,37,8,56
NCIH2170_TOTAL_HER2_R1_G1_2404_18_Merge(RGB).tif,NCIH2170_TOTAL_HER2_R1_G1_2404_18_Merge(RGB),503,4,499,286,171,59,273,56,503
NCIH2170_TOTAL_HER2_R1_G0_2501_126_Merge.tif (RGB).tif,NCIH2170_TOTAL_HER2_R1_G0_2501_126,272,0,272,104,45,41,186,18,272
NCIH2170_TOTAL_HER2_R1_G1_2404_125_Merge(RGB).tif,NCIH2170_TOTAL_HER2_R1_G1_2404_125_Merge(RGB),193,4,189,144,59,42,92,43,193
NCIH2170_TOTAL_HER2_R1_G2_24_10_60_Merge(RGB).tif,NCIH2170_TOTAL_HER2_R1_G2_24_10_60_Merge(RGB),267,0,267,81,56,18,193,7,267
NCIH2170_LOW_HER2_R1_G1_2404_53_Merge(RGB).tif,NCIH2170_LOW_HER2_R1_G1_2404_53_Merge(RGB),83,7,76,34,19,8,56,7,83
NCIH2170_LOW_HER2_R1_G1_2404_52_Merge(RGB).tif,NCIH2170_LOW_HER2_R1_G1_2404_52_Merge(RGB),123,14,109,74,56,11,56,7,123
NCIH2170_HIGH_HER2_R1_G2_24_10_73_Merge(RGB).tif,NCIH2170_HIGH_HER2_R1_G2_24_10_73_Merge(RGB),121,4,117,68,24,27,70,17,121
NCIH2170_TOTAL_HER2_R1_G1_2404_1_Merge(RGB).tif,NCIH2170_TOTAL_HER2_R1_G1_2404_1_Merge(RGB),525,34,491,292,172,70,283,50,525
NCIH2170_TOTAL_HER2_R1_G1_2404_129_Merge(RGB).tif,NCIH2170_TOTAL_HER2_R1_G1_2404_129_Merge(RGB),173,8,165,98,53,27,93,18,173
NCIH2170_TOTAL_HER2_R1_G2_24_10_8_Merge(RGB).tif,NCIH2170_TOTAL_HER2_R1_G2_24_10_8_Merge(RGB),100,1,99,97,16,37,47,44,100
NCIH2170_HIGH_HER2_R1_G2_24_10_2_Merge(RGB).tif,NCIH2170_HIGH_HER2_R1_G2_24_10_2_Merge(RGB),359,6,353,143,78,37,244,28,359
NCIH2170_LOW_HER2_R1_G0_2501_33_Merge.tif (RGB).tif,NCIH2170_LOW_HER2_R1_G0_2501_33,254,9,245,52,23,25,206,4,254
NCIH2170_TOTAL_HER2_R1_G0_2501_116_Merge.tif (RGB).tif,NCIH2170_TOTAL_HER2_R1_G0_2501_116,235,0,235,64,21,38,176,5,235
NCIH2170_TOTAL_HER2_R1_G1_2404_44_Merge(RGB).tif,NCIH2170_TOTAL_HER2_R1_G1_2404_44_Merge(RGB),148,6,142,148,94,21,33,33,148
NCIH2170_TOTAL_HER2_R1_G0_2501_49_Merge.tif (RGB).tif,NCIH2170_TOTAL_HER2_R1_G0_2501_49,81,0,81,12,5,7,69,0,81
NCIH2170_HIGH_HER2_R1_G0_2501_67_Merge.tif (RGB).tif,NCIH2170_HIGH_HER2_R1_G0_2501_67,240,0,240,94,46,41,153,7,240
NCIH2170_HIGH_HER2_R1_G2_24_10_119_Merge(RGB).tif,NCIH2170_HIGH_HER2_R1_G2_24_10_119_Merge(RGB),280,0,280,177,49,76,155,52,280
NCIH2170_LOW_HER2_R1_G2_24_10_68_Merge(RGB).tif,NCIH2170_LOW_HER2_R1_G2_24_10_68_Merge(RGB),59,0,59,44,19,14,26,11,59
NCIH2170_TOTAL_HER2_R1_G2_24_10_87_Merge(RGB).tif,NCIH2170_TOTAL_HER2_R1_G2_24_10_87_Merge(RGB),272,0,272,89,67,16,189,6,272
NCIH2170_TOTAL_HER2_R1_G1_2404_121_Merge(RGB).tif,NCIH2170_TOTAL_HER2_R1_G1_2404_121_Merge(RGB),286,5,281,205,111,49,126,45,286
NCIH2170_LOW_HER2_R1_G1_2404_2_Merge(RGB).tif,NCIH2170_LOW_HER2_R1_G1_2404_2_Merge(RGB),465,41,424,118,36,50,379,32,465
NCIH2170_LOW_HER2_R1_G2_24_10_77_Merge(RGB).tif,NCIH2170_LOW_HER2_R1_G2_24_10_77_Merge(RGB),299,1,298,70,45,17,237,8,299
NCIH2170_LOW_HER2_R1_G0_2501_86_Merge.tif (RGB).tif,NCIH2170_LOW_HER2_R1_G0_2501_86,254,12,242,74,25,45,184,4,254
NCIH2170_HIGH_HER2_R1_G0_2501_64_Merge.tif (RGB).tif,NCIH2170_HIGH_HER2_R1_G0_2501_64,361,2,359,142,50,65,246,27,361
NCIH2170_HIGH_HER2_R1_G0_2501_74_Merge.tif (RGB).tif,NCIH2170_HIGH_HER2_R1_G0_2501_74,157,7,150,64,21,32,104,11,157
NCIH2170_HIGH_HER2_R1_G2_24_10_39_Merge(RGB).tif,NCIH2170_HIGH_HER2_R1_G2_24_10_39_Merge(RGB),71,11,60,32,21,7,43,4,71
NCIH2170_LOW_HER2_R1_G0_2501_68_Merge.tif (RGB).tif,NCIH2170_LOW_HER2_R1_G0_2501_68,82,7,75,16,5,4,73,7,82
NCIH2170_TOTAL_HER2_R1_G1_2404_126_Merge(RGB).tif,NCIH2170_TOTAL_HER2_R1_G1_2404_126_Merge(RGB),140,17,123,99,63,13,64,23,140
NCIH2170_TOTAL_HER2_R1_G1_2404_84_Merge(RGB).tif,NCIH2170_TOTAL_HER2_R1_G1_2404_84_Merge(RGB),120,1,119,103,43,23,54,37,120
NCIH2170_TOTAL_HER2_R1_G0_2501_48_Merge.tif (RGB).tif,NCIH2170_TOTAL_HER2_R1_G0_2501_48,145,7,138,15,8,5,132,2,145
NCIH2170_TOTAL_HER2_R1_G1_2404_87_Merge(RGB).tif,NCIH2170_TOTAL_HER2_R1_G1_2404_87_Merge(RGB),144,0,144,86,40,21,83,25,144
NCIH2170_LOW_HER2_R1_G0_2501_45_Merge.tif (RGB).tif,NCIH2170_LOW_HER2_R1_G0_2501_45,92,26,66,10,5,4,83,1,92
NCIH2170_HIGH_HER2_R1_G1_2404_S2_46_Merge(RGB).tif,NCIH2170_HIGH_HER2_R1_G1_2404_S2_46_Merge(RGB),560,5,555,145,66,60,434,19,560
NCIH2170_HIGH_HER2_R1_G1_2404_S2_80_Merge(RGB).tif,NCIH2170_HIGH_HER2_R1_G1_2404_S2_80_Merge(RGB),129,15,114,52,17,23,89,12,129
NCIH2170_HIGH_HER2_R1_G0_2501_119_Merge.tif (RGB).tif,NCIH2170_HIGH_HER2_R1_G0_2501_119,157,12,145,30,4,25,128,1,157
NCIH2170_TOTAL_HER2_R1_G0_2501_97_Merge.tif (RGB).tif,NCIH2170_TOTAL_HER2_R1_G0_2501_97,272,0,272,56,19,35,218,2,272
NCIH2170_TOTAL_HER2_R1_G1_2404_70_Merge(RGB).tif,NCIH2170_TOTAL_HER2_R1_G1_2404_70_Merge(RGB),319,44,275,76,29,30,260,17,319
NCIH2170_TOTAL_HER2_R1_G1_2404_39_Merge(RGB).tif,NCIH2170_TOTAL_HER2_R1_G1_2404_39_Merge(RGB),152,0,152,125,39,39,74,47,152
NCIH2170_HIGH_HER2_R1_G0_2501_81_Merge.tif (RGB).tif,NCIH2170_HIGH_HER2_R1_G0_2501_81,124,2,122,83,37,23,64,23,124
NCIH2170_TOTAL_HER2_R1_G2_24_10_22_Merge(RGB).tif,NCIH2170_TOTAL_HER2_R1_G2_24_10_22_Merge(RGB),282,4,278,82,43,34,205,5,282
NCIH2170_HIGH_HER2_R1_G2_24_10_3_Merge(RGB).tif,NCIH2170_HIGH_HER2_R1_G2_24_10_3_Merge(RGB),337,9,328,119,59,41,237,19,337
NCIH2170_TOTAL_HER2_R1_G0_2501_21B_Merge.tif (RGB).tif,NCIH2170_TOTAL_HER2_R1_G0_2501_21B,129,2,127,88,31,42,56,15,129
NCIH2170_TOTAL_HER2_R1_G0_2501_71_Merge.tif (RGB).tif,NCIH2170_TOTAL_HER2_R1_G0_2501_71,88,0,88,37,12,15,61,10,88
NCIH2170_LOW_HER2_R1_G1_2404_25_Merge(RGB).tif,NCIH2170_LOW_HER2_R1_G1_2404_25_Merge(RGB),65,0,65,12,6,4,55,2,65
NCIH2170_HIGH_HER2_R1_G1_2404_S2_96_Merge(RGB).tif,NCIH2170_HIGH_HER2_R1_G1_2404_S2_96_Merge(RGB),263,10,253,116,73,32,158,11,263
NCIH2170_LOW_HER2_R1_G0_2501_91_Merge.tif (RGB).tif,NCIH2170_LOW_HER2_R1_G0_2501_91,66,1,65,12,7,2,57,3,66
NCIH2170_TOTAL_HER2_R1_G0_2501_68_Merge.tif (RGB).tif,NCIH2170_TOTAL_HER2_R1_G0_2501_68,206,0,206,57,11,46,149,0,206
NCIH2170_HIGH_HER2_R1_G0_2501_107_Merge.tif (RGB).tif,NCIH2170_HIGH_HER2_R1_G0_2501_107,301,2,299,97,22,55,224,20,301
NCIH2170_HIGH_HER2_R1_G1_2404_S2_99_Merge(RGB).tif,NCIH2170_HIGH_HER2_R1_G1_2404_S2_99_Merge(RGB),255,0,255,94,47,31,177,16,255
NCIH2170_HIGH_HER2_R1_G2_24_10_125_Merge(RGB).tif,NCIH2170_HIGH_HER2_R1_G2_24_10_125_Merge(RGB),235,2,233,139,74,43,118,22,235
NCIH2170_LOW_HER2_R1_G2_24_10_24_Merge(RGB).tif,NCIH2170_LOW_HER2_R1_G2_24_10_24_Merge(RGB),83,0,83,23,5,16,62,2,83
NCIH2170_HIGH_HER2_R1_G0_2501_51_Merge.tif (RGB).tif,NCIH2170_HIGH_HER2_R1_G0_2501_51,151,14,137,50,16,25,110,9,151
NCIH2170_TOTAL_HER2_R1_G0_2501_84_Merge.tif (RGB).tif,NCIH2170_TOTAL_HER2_R1_G0_2501_84,83,0,83,39,17,15,51,7,83
NCIH2170_LOW_HER2_R1_G1_2404_22_Merge(RGB).tif,NCIH2170_LOW_HER2_R1_G1_2404_22_Merge(RGB),34,3,31,43,10,8,16,25,34
NCIH2170_LOW_HER2_R1_G2_24_10_39_Merge(RGB).tif,NCIH2170_LOW_HER2_R1_G2_24_10_39_Merge(RGB),121,0,121,83,48,16,57,19,121
NCIH2170_LOW_HER2_R1_G1_2404_72_Merge(RGB).tif,NCIH2170_LOW_HER2_R1_G1_2404_72_Merge(RGB),72,21,51,34,14,15,43,5,72
NCIH2170_TOTAL_HER2_R1_G0_2501_63_Merge.tif (RGB).tif,NCIH2170_TOTAL_HER2_R1_G0_2501_63,757,0,757,166,45,118,594,3,757
NCIH2170_LOW_HER2_R1_G0_2501_124_Merge.tif (RGB).tif,NCIH2170_LOW_HER2_R1_G0_2501_124,176,7,169,52,19,29,128,4,176
NCIH2170_TOTAL_HER2_R1_G0_2501_85_Merge.tif (RGB).tif,NCIH2170_TOTAL_HER2_R1_G0_2501_85,364,1,363,120,40,73,251,7,364
NCIH2170_LOW_HER2_R1_G2_24_10_120_Merge(RGB).tif,NCIH2170_LOW_HER2_R1_G2_24_10_120_Merge(RGB),106,1,105,51,27,11,68,13,106
NCIH2170_HIGH_HER2_R1_G2_24_10_60_Merge(RGB).tif,NCIH2170_HIGH_HER2_R1_G2_24_10_60_Merge(RGB),408,4,404,185,78,78,252,29,408
NCIH2170_LOW_HER2_R1_G1_2404_67_Merge(RGB).tif,NCIH2170_LOW_HER2_R1_G1_2404_67_Merge(RGB),97,10,87,36,20,7,70,9,97
NCIH2170_LOW_HER2_R1_G1_2404_83_Merge(RGB).tif,NCIH2170_LOW_HER2_R1_G1_2404_83_Merge(RGB),137,0,137,189,46,33,58,110,137
NCIH2170_TOTAL_HER2_R1_G0_2501_112_Merge.tif (RGB).tif,NCIH2170_TOTAL_HER2_R1_G0_2501_112,94,0,94,35,18,13,63,4,94
NCIH2170_TOTAL_HER2_R1_G1_2404_5_Merge(RGB).tif,NCIH2170_TOTAL_HER2_R1_G1_2404_5_Merge(RGB),84,7,77,62,35,7,42,20,84
NCIH2170_HIGH_HER2_R1_G1_2404_S2_55_Merge(RGB).tif,NCIH2170_HIGH_HER2_R1_G1_2404_S2_55_Merge(RGB),283,0,283,202,117,60,106,25,283
NCIH2170_LOW_HER2_R1_G2_24_10_101_Merge(RGB).tif,NCIH2170_LOW_HER2_R1_G2_24_10_101_Merge(RGB),182,0,182,76,43,20,119,13,182
NCIH2170_LOW_HER2_R1_G1_2404_35_Merge(RGB).tif,NCIH2170_LOW_HER2_R1_G1_2404_35_Merge(RGB),328,3,325,259,151,49,128,59,328
NCIH2170_LOW_HER2_R1_G2_24_10_30_Merge(RGB).tif,NCIH2170_LOW_HER2_R1_G2_24_10_30_Merge(RGB),239,5,234,53,35,14,190,4,239
NCIH2170_LOW_HER2_R1_G2_24_10_106_Merge(RGB).tif,NCIH2170_LOW_HER2_R1_G2_24_10_106_Merge(RGB),136,12,124,53,31,15,90,7,136
NCIH2170_TOTAL_HER2_R1_G0_2501_32_Merge.tif (RGB).tif,NCIH2170_TOTAL_HER2_R1_G0_2501_32,86,0,86,19,8,9,69,2,86
NCIH2170_LOW_HER2_R1_G2_24_10_42_Merge(RGB).tif,NCIH2170_LOW_HER2_R1_G2_24_10_42_Merge(RGB),149,24,125,77,33,26,90,18,149
NCIH2170_LOW_HER2_R1_G2_24_10_128_Merge(RGB).tif,NCIH2170_LOW_HER2_R1_G2_24_10_128_Merge(RGB),198,33,165,63,30,21,147,12,198
NCIH2170_HIGH_HER2_R1_G2_24_10_46_Merge(RGB).tif,NCIH2170_HIGH_HER2_R1_G2_24_10_46_Merge(RGB),329,9,320,84,30,40,259,14,329
NCIH2170_HIGH_HER2_R1_G1_2404_S2_85_Merge(RGB).tif,NCIH2170_HIGH_HER2_R1_G1_2404_S2_85_Merge(RGB),262,0,262,123,78,28,156,17,262
NCIH2170_HIGH_HER2_R1_G0_2501_123_Merge.tif (RGB).tif,NCIH2170_HIGH_HER2_R1_G0_2501_123,218,15,203,52,17,32,169,3,218
NCIH2170_HIGH_HER2_R1_G0_2501_94_Merge.tif (RGB).tif,NCIH2170_HIGH_HER2_R1_G0_2501_94,421,15,406,100,36,60,325,4,421
NCIH2170_HIGH_HER2_R1_G2_24_10_101_Merge(RGB).tif,NCIH2170_HIGH_HER2_R1_G2_24_10_101_Merge(RGB),116,5,111,22,7,13,96,2,116
NCIH2170_LOW_HER2_R1_G0_2501_100_Merge.tif (RGB).tif,NCIH2170_LOW_HER2_R1_G0_2501_100,102,2,100,41,15,21,66,5,102
NCIH2170_LOW_HER2_R1_G0_2501_60_Merge.tif (RGB).tif,NCIH2170_LOW_HER2_R1_G0_2501_60,97,3,94,22,15,5,77,2,97
NCIH2170_HIGH_HER2_R1_G0_2501_39_Merge.tif (RGB).tif,NCIH2170_HIGH_HER2_R1_G0_2501_39,148,5,143,64,25,26,97,13,148
NCIH2170_HIGH_HER2_R1_G1_2404_S2_2_Merge(RGB).tif,NCIH2170_HIGH_HER2_R1_G1_2404_S2_2_Merge(RGB),107,3,104,113,47,22,38,44,107
NCIH2170_LOW_HER2_R1_G0_2501_17_Merge.tif (RGB).tif,NCIH2170_LOW_HER2_R1_G0_2501_17,104,3,101,24,12,12,80,0,104
NCIH2170_HIGH_HER2_R1_G1_2404_S2_122_Merge(RGB).tif,NCIH2170_HIGH_HER2_R1_G1_2404_S2_122_Merge(RGB),258,11,247,132,71,49,138,12,258
NCIH2170_TOTAL_HER2_R1_G0_2501_47A_Merge.tif (RGB).tif,NCIH2170_TOTAL_HER2_R1_G0_2501_47A,232,0,232,90,46,36,150,8,232
NCIH2170_HIGH_HER2_R1_G1_2404_S2_111_Merge(RGB).tif,NCIH2170_HIGH_HER2_R1_G1_2404_S2_111_Merge(RGB),100,5,95,52,35,10,55,7,100
NCIH2170_TOTAL_HER2_R1_G0_2501_37_Merge.tif (RGB).tif,NCIH2170_TOTAL_HER2_R1_G0_2501_37,431,6,425,171,70,89,272,12,431
NCIH2170_HIGH_HER2_R1_G1_2404_S2_36_Merge(RGB).tif,NCIH2170_HIGH_HER2_R1_G1_2404_S2_36_Merge(RGB),309,0,309,50,15,26,268,9,309
NCIH2170_LOW_HER2_R1_G2_24_10_84_Merge(RGB).tif,NCIH2170_LOW_HER2_R1_G2_24_10_84_Merge(RGB),268,12,256,58,36,19,213,3,268
NCIH2170_LOW_HER2_R1_G0_2501_14_Merge.tif (RGB).tif,NCIH2170_LOW_HER2_R1_G0_2501_14,177,4,173,41,9,28,140,4,177
NCIH2170_TOTAL_HER2_R1_G1_2404_9_Merge(RGB).tif,NCIH2170_TOTAL_HER2_R1_G1_2404_9_Merge(RGB),178,7,171,68,31,24,123,13,178
NCIH2170_HIGH_HER2_R1_G1_2404_S2_93_Merge(RGB).tif,NCIH2170_HIGH_HER2_R1_G1_2404_S2_93_Merge(RGB),98,5,93,53,27,20,51,6,98
NCIH2170_LOW_HER2_R1_G2_24_10_69_Merge(RGB).tif,NCIH2170_LOW_HER2_R1_G2_24_10_69_Merge(RGB),232,0,232,78,41,28,163,9,232
NCIH2170_HIGH_HER2_R1_G1_2404_S2_1_Merge(RGB).tif,NCIH2170_HIGH_HER2_R1_G1_2404_S2_1_Merge(RGB),160,4,156,106,69,16,75,21,160
NCIH2170_HIGH_HER2_R1_G0_2501_96_Merge.tif (RGB).tif,NCIH2170_HIGH_HER2_R1_G0_2501_96,194,2,192,55,19,30,145,6,194
NCIH2170_LOW_HER2_R1_G0_2501_62_Merge.tif (RGB).tif,NCIH2170_LOW_HER2_R1_G0_2501_62,138,15,123,46,13,24,101,9,138
NCIH2170_TOTAL_HER2_R1_G0_2501_53_Merge.tif (RGB).tif,NCIH2170_TOTAL_HER2_R1_G0_2501_53,150,5,145,42,21,16,113,5,150
NCIH2170_LOW_HER2_R1_G1_2404_20_Merge(RGB).tif,NCIH2170_LOW_HER2_R1_G1_2404_20_Merge(RGB),109,0,109,103,14,45,50,44,109
NCIH2170_HIGH_HER2_R1_G1_2404_S2_45_Merge(RGB).tif,NCIH2170_HIGH_HER2_R1_G1_2404_S2_45_Merge(RGB),813,0,813,177,85,61,667,31,813
NCIH2170_LOW_HER2_R1_G1_2404_10_Merge(RGB).tif,NCIH2170_LOW_HER2_R1_G1_2404_10_Merge(RGB),100,11,89,52,32,12,56,8,100
NCIH2170_HIGH_HER2_R1_G2_24_10_91_Merge(RGB).tif,NCIH2170_HIGH_HER2_R1_G2_24_10_91_Merge(RGB),128,28,100,69,37,18,73,14,128
NCIH2170_LOW_HER2_R1_G1_2404_42_Merge(RGB).tif,NCIH2170_LOW_HER2_R1_G1_2404_42_Merge(RGB),78,25,53,27,12,9,57,6,78
NCIH2170_TOTAL_HER2_R1_G2_24_10_66_Merge(RGB).tif,NCIH2170_TOTAL_HER2_R1_G2_24_10_66_Merge(RGB),180,7,173,60,27,25,128,8,180
NCIH2170_HIGH_HER2_R1_G0_2501_110_Merge.tif (RGB).tif,NCIH2170_HIGH_HER2_R1_G0_2501_110,190,2,188,53,13,21,156,19,190
NCIH2170_LOW_HER2_R1_G0_2501_109_Merge.tif (RGB).tif,NCIH2170_LOW_HER2_R1_G0_2501_109,135,14,121,73,20,36,79,17,135
NCIH2170_LOW_HER2_R1_G0_2501_5_Merge.tif (RGB).tif,NCIH2170_LOW_HER2_R1_G0_2501_5,87,0,87,56,0,13,74,43,87
NCIH2170_HIGH_HER2_R1_G2_24_10_49_Merge(RGB).tif,NCIH2170_HIGH_HER2_R1_G2_24_10_49_Merge(RGB),127,4,123,63,26,30,71,7,127
NCIH2170_TOTAL_HER2_R1_G0_2501_56B_Merge.tif (RGB).tif,NCIH2170_TOTAL_HER2_R1_G0_2501_56B,181,13,168,26,9,17,155,0,181
NCIH2170_LOW_HER2_R1_G2_24_10_52_Merge(RGB).tif,NCIH2170_LOW_HER2_R1_G2_24_10_52_Merge(RGB),164,6,158,134,67,32,65,35,164
NCIH2170_TOTAL_HER2_R1_G1_2404_42_Merge(RGB).tif,NCIH2170_TOTAL_HER2_R1_G1_2404_42_Merge(RGB),202,0,202,105,56,31,115,18,202
NCIH2170_TOTAL_HER2_R1_G0_2501_106_Merge.tif (RGB).tif,NCIH2170_TOTAL_HER2_R1_G0_2501_106,132,0,132,26,10,16,106,0,132
NCIH2170_HIGH_HER2_R1_G2_24_10_27_Merge(RGB).tif,NCIH2170_HIGH_HER2_R1_G2_24_10_27_Merge(RGB),204,1,203,98,55,26,123,17,204
NCIH2170_HIGH_HER2_R1_G2_24_10_20_Merge(RGB).tif,NCIH2170_HIGH_HER2_R1_G2_24_10_20_Merge(RGB),486,15,471,111,48,58,380,5,486
NCIH2170_HIGH_HER2_R1_G0_2501_24_Merge.tif (RGB).tif,NCIH2170_HIGH_HER2_R1_G0_2501_24,155,21,134,27,10,14,131,3,155
NCIH2170_HIGH_HER2_R1_G2_24_10_15A_Merge(RGB).tif,NCIH2170_HIGH_HER2_R1_G2_24_10_15A_Merge(RGB),398,21,377,34,11,22,365,1,398
NCIH2170_HIGH_HER2_R1_G0_2501_122_Merge.tif (RGB).tif,NCIH2170_HIGH_HER2_R1_G0_2501_122,205,5,200,75,28,38,139,9,205
NCIH2170_LOW_HER2_R1_G0_2501_19_Merge.tif (RGB).tif,NCIH2170_LOW_HER2_R1_G0_2501_19,428,3,425,136,43,71,314,22,428
NCIH2170_TOTAL_HER2_R1_G0_2501_98_Merge.tif (RGB).tif,NCIH2170_TOTAL_HER2_R1_G0_2501_98,233,0,233,82,18,38,177,26,233
NCIH2170_HIGH_HER2_R1_G1_2404_S2_100_Merge(RGB).tif,NCIH2170_HIGH_HER2_R1_G1_2404_S2_100_Merge(RGB),157,0,157,103,57,24,76,22,157
NCIH2170_TOTAL_HER2_R1_G1_2404_46_Merge(RGB).tif,NCIH2170_TOTAL_HER2_R1_G1_2404_46_Merge(RGB),266,11,255,196,118,35,113,43,266
NCIH2170_HIGH_HER2_R1_G1_2404_S2_79_Merge(RGB).tif,NCIH2170_HIGH_HER2_R1_G1_2404_S2_79_Merge(RGB),155,8,147,72,40,21,94,11,155
NCIH2170_LOW_HER2_R1_G0_2501_72_Merge.tif (RGB).tif,NCIH2170_LOW_HER2_R1_G0_2501_72,273,4,269,117,25,78,170,14,273
NCIH2170_HIGH_HER2_R1_G1_2404_S2_7_Merge(RGB).tif,NCIH2170_HIGH_HER2_R1_G1_2404_S2_7_Merge(RGB),190,8,182,114,63,34,93,17,190
NCIH2170_LOW_HER2_R1_G0_2501_75_Merge.tif (RGB).tif,NCIH2170_LOW_HER2_R1_G0_2501_75,232,1,231,73,18,45,169,10,232
NCIH2170_LOW_HER2_R1_G1_2404_8_Merge(RGB).tif,NCIH2170_LOW_HER2_R1_G1_2404_8_Merge(RGB),113,0,113,24,8,10,95,6,113
NCIH2170_HIGH_HER2_R1_G2_24_10_76_Merge(RGB).tif,NCIH2170_HIGH_HER2_R1_G2_24_10_76_Merge(RGB),316,28,288,95,35,45,236,15,316
NCIH2170_TOTAL_HER2_R1_G1_2404_105_Merge(RGB).tif,NCIH2170_TOTAL_HER2_R1_G1_2404_105_Merge(RGB),108,4,104,78,34,16,58,28,108
NCIH2170_TOTAL_HER2_R1_G0_2501_15_Merge.tif (RGB).tif,NCIH2170_TOTAL_HER2_R1_G0_2501_15,182,2,180,46,15,24,143,7,182
NCIH2170_HIGH_HER2_R1_G1_2404_S2_35_Merge(RGB).tif,NCIH2170_HIGH_HER2_R1_G1_2404_S2_35_Merge(RGB),130,19,111,42,22,15,93,5,130
NCIH2170_LOW_HER2_R1_G2_24_10_90_Merge(RGB).tif,NCIH2170_LOW_HER2_R1_G2_24_10_90_Merge(RGB),388,11,377,103,35,55,298,13,388
NCIH2170_TOTAL_HER2_R1_G2_24_10_14_Merge(RGB).tif,NCIH2170_TOTAL_HER2_R1_G2_24_10_14_Merge(RGB),120,2,118,68,38,17,65,13,120
NCIH2170_HIGH_HER2_R1_G1_2404_S2_40_Merge(RGB).tif,NCIH2170_HIGH_HER2_R1_G1_2404_S2_40_Merge(RGB),177,0,177,72,42,27,108,3,177
NCIH2170_HIGH_HER2_R1_G2_24_10_14_Merge(RGB).tif,NCIH2170_HIGH_HER2_R1_G2_24_10_14_Merge(RGB),375,7,368,142,44,75,256,23,375
NCIH2170_HIGH_HER2_R1_G1_2404_S2_23_Merge(RGB).tif,NCIH2170_HIGH_HER2_R1_G1_2404_S2_23_Merge(RGB),327,3,324,129,62,48,217,19,327
NCIH2170_TOTAL_HER2_R1_G0_2501_114B_Merge.tif (RGB).tif,NCIH2170_TOTAL_HER2_R1_G0_2501_114B,164,4,160,61,23,29,112,9,164
NCIH2170_LOW_HER2_R1_G1_2404_77_Merge(RGB).tif,NCIH2170_LOW_HER2_R1_G1_2404_77_Merge(RGB),138,3,135,100,61,17,60,22,138
NCIH2170_LOW_HER2_R1_G2_24_10_9_Merge(RGB).tif,NCIH2170_LOW_HER2_R1_G2_24_10_9_Merge(RGB),236,2,234,119,79,30,127,10,236
NCIH2170_HIGH_HER2_R1_G0_2501_111_Merge.tif (RGB).tif,NCIH2170_HIGH_HER2_R1_G0_2501_111,307,2,305,83,24,53,230,6,307
NCIH2170_LOW_HER2_R1_G2_24_10_91_Merge(RGB).tif,NCIH2170_LOW_HER2_R1_G2_24_10_91_Merge(RGB),177,19,158,51,22,20,135,9,177
NCIH2170_LOW_HER2_R1_G1_2404_75_Merge(RGB).tif,NCIH2170_LOW_HER2_R1_G1_2404_75_Merge(RGB),472,6,466,152,63,72,337,17,472
NCIH2170_LOW_HER2_R1_G0_2501_10_Merge.tif (RGB).tif,NCIH2170_LOW_HER2_R1_G0_2501_10,157,13,144,41,3,23,131,15,157
NCIH2170_HIGH_HER2_R1_G0_2501_38_Merge.tif (RGB).tif,NCIH2170_HIGH_HER2_R1_G0_2501_38,138,3,135,36,9,19,110,8,138
NCIH2170_HIGH_HER2_R1_G1_2404_S2_112_Merge(RGB).tif,NCIH2170_HIGH_HER2_R1_G1_2404_S2_112_Merge(RGB),289,9,280,157,50,57,182,50,289
NCIH2170_HIGH_HER2_R1_G1_2404_S2_124_Merge(RGB).tif,NCIH2170_HIGH_HER2_R1_G1_2404_S2_124_Merge(RGB),51,1,50,41,23,12,16,6,51
NCIH2170_TOTAL_HER2_R1_G0_2501_8_Merge.tif (RGB).tif,NCIH2170_TOTAL_HER2_R1_G0_2501_8,193,8,185,39,2,20,171,17,193
NCIH2170_LOW_HER2_R1_G0_2501_88_Merge.tif (RGB).tif,NCIH2170_LOW_HER2_R1_G0_2501_88,357,5,352,97,41,47,269,9,357
NCIH2170_TOTAL_HER2_R1_G0_2501_122_Merge.tif (RGB).tif,NCIH2170_TOTAL_HER2_R1_G0_2501_122,91,0,91,39,11,21,59,7,91
NCIH2170_LOW_HER2_R1_G2_24_10_18_Merge(RGB).tif,NCIH2170_LOW_HER2_R1_G2_24_10_18_Merge(RGB),239,4,235,67,29,25,185,13,239
NCIH2170_HIGH_HER2_R1_G1_2404_S2_13_Merge(RGB).tif,NCIH2170_HIGH_HER2_R1_G1_2404_S2_13_Merge(RGB),478,28,450,190,83,74,321,33,478
NCIH2170_TOTAL_HER2_R1_G1_2404_45_Merge(RGB).tif,NCIH2170_TOTAL_HER2_R1_G1_2404_45_Merge(RGB),46,2,44,36,15,11,20,10,46
NCIH2170_LOW_HER2_R1_G2_24_10_112_Merge(RGB).tif,NCIH2170_LOW_HER2_R1_G2_24_10_112_Merge(RGB),230,25,205,59,22,27,181,10,230
NCIH2170_LOW_HER2_R1_G0_2501_27_Merge.tif (RGB).tif,NCIH2170_LOW_HER2_R1_G0_2501_27,188,9,179,29,10,18,160,1,188
NCIH2170_HIGH_HER2_R1_G1_2404_S2_5_Merge(RGB).tif,NCIH2170_HIGH_HER2_R1_G1_2404_S2_5_Merge(RGB),352,0,352,296,148,76,128,72,352
NCIH2170_TOTAL_HER2_R1_G0_2501_64_Merge.tif (RGB).tif,NCIH2170_TOTAL_HER2_R1_G0_2501_64,170,1,169,53,24,21,125,8,170
NCIH2170_HIGH_HER2_R1_G0_2501_6_Merge.tif (RGB).tif,NCIH2170_HIGH_HER2_R1_G0_2501_6,237,3,234,94,1,32,204,61,237
NCIH2170_LOW_HER2_R1_G2_24_10_110_Merge(RGB).tif,NCIH2170_LOW_HER2_R1_G2_24_10_110_Merge(RGB),249,7,242,168,30,71,148,67,249
NCIH2170_TOTAL_HER2_R1_G2_24_10_124_Merge(RGB).tif,NCIH2170_TOTAL_HER2_R1_G2_24_10_124_Merge(RGB),225,0,225,66,41,18,166,7,225
NCIH2170_TOTAL_HER2_R1_G1_2404_101_Merge(RGB).tif,NCIH2170_TOTAL_HER2_R1_G1_2404_101_Merge(RGB),261,97,164,48,20,26,215,2,261
NCIH2170_HIGH_HER2_R1_G0_2501_61_Merge.tif (RGB).tif,NCIH2170_HIGH_HER2_R1_G0_2501_61,287,0,287,67,27,35,225,5,287
NCIH2170_LOW_HER2_R1_G0_2501_89_Merge.tif (RGB).tif,NCIH2170_LOW_HER2_R1_G0_2501_89,70,14,56,40,11,12,47,17,70
NCIH2170_LOW_HER2_R1_G0_2501_9_Merge.tif (RGB).tif,NCIH2170_LOW_HER2_R1_G0_2501_9,120,2,118,27,0,3,117,24,120
NCIH2170_LOW_HER2_R1_G2_24_10_10_Merge(RGB).tif,NCIH2170_LOW_HER2_R1_G2_24_10_10_Merge(RGB),163,9,154,47,23,14,126,10,163
NCIH2170_HIGH_HER2_R1_G2_24_10_81_Merge(RGB).tif,NCIH2170_HIGH_HER2_R1_G2_24_10_81_Merge(RGB),350,3,347,129,44,67,239,18,350
NCIH2170_TOTAL_HER2_R1_G2_24_10_13_Merge(RGB).tif,NCIH2170_TOTAL_HER2_R1_G2_24_10_13_Merge(RGB),197,11,186,72,25,32,140,15,197
NCIH2170_LOW_HER2_R1_G1_2404_61_Merge(RGB).tif,NCIH2170_LOW_HER2_R1_G1_2404_61_Merge(RGB),159,2,157,97,64,19,76,14,159
NCIH2170_LOW_HER2_R1_G1_2404_7_Merge(RGB).tif,NCIH2170_LOW_HER2_R1_G1_2404_7_Merge(RGB),402,0,402,236,146,55,201,35,402
NCIH2170_HIGH_HER2_R1_G1_2404_S2_22_Merge(RGB).tif,NCIH2170_HIGH_HER2_R1_G1_2404_S2_22_Merge(RGB),111,4,107,54,34,11,66,9,111
NCIH2170_LOW_HER2_R1_G1_2404_40_Merge(RGB).tif,NCIH2170_LOW_HER2_R1_G1_2404_40_Merge(RGB),393,3,390,142,87,35,271,20,393
NCIH2170_TOTAL_HER2_R1_G2_24_10_67_Merge(RGB).tif,NCIH2170_TOTAL_HER2_R1_G2_24_10_67_Merge(RGB),486,8,478,171,72,75,339,24,486
NCIH2170_HIGH_HER2_R1_G0_2501_80_Merge.tif (RGB).tif,NCIH2170_HIGH_HER2_R1_G0_2501_80,116,7,109,59,27,26,63,6,116
NCIH2170_TOTAL_HER2_R1_G0_2501_42_Merge.tif (RGB).tif,NCIH2170_TOTAL_HER2_R1_G0_2501_42,400,3,397,90,22,64,314,4,400
NCIH2170_TOTAL_HER2_R1_G1_2404_85_Merge(RGB).tif,NCIH2170_TOTAL_HER2_R1_G1_2404_85_Merge(RGB),235,2,233,110,53,33,149,24,235
NCIH2170_TOTAL_HER2_R1_G0_2501_51_Merge.tif (RGB).tif,NCIH2170_TOTAL_HER2_R1_G0_2501_51,138,0,138,97,40,40,58,17,138
NCIH2170_HIGH_HER2_R1_G2_24_10_5_Merge(RGB).tif,NCIH2170_HIGH_HER2_R1_G2_24_10_5_Merge(RGB),254,8,246,98,54,26,174,18,254
NCIH2170_TOTAL_HER2_R1_G1_2404_67_Merge(RGB).tif,NCIH2170_TOTAL_HER2_R1_G1_2404_67_Merge(RGB),262,0,262,85,53,22,187,10,262
NCIH2170_TOTAL_HER2_R1_G2_24_10_97_Merge(RGB).tif,NCIH2170_TOTAL_HER2_R1_G2_24_10_97_Merge(RGB),48,0,48,68,15,11,22,42,48
NCIH2170_HIGH_HER2_R1_G2_24_10_105A_Merge(RGB).tif,NCIH2170_HIGH_HER2_R1_G2_24_10_105A_Merge(RGB),98,10,88,26,6,16,76,4,98
NCIH2170_HIGH_HER2_R1_G1_2404_S2_104_Merge(RGB).tif,NCIH2170_HIGH_HER2_R1_G1_2404_S2_104_Merge(RGB),282,0,282,140,71,36,175,33,282
NCIH2170_TOTAL_HER2_R1_G1_2404_24_Merge(RGB).tif,NCIH2170_TOTAL_HER2_R1_G1_2404_24_Merge(RGB),101,3,98,67,37,16,48,14,101
NCIH2170_HIGH_HER2_R1_G2_24_10_114_Merge(RGB).tif,NCIH2170_HIGH_HER2_R1_G2_24_10_114_Merge(RGB),209,4,205,60,21,25,163,14,209
NCIH2170_TOTAL_HER2_R1_G2_24_10_48_Merge(RGB).tif,NCIH2170_TOTAL_HER2_R1_G2_24_10_48_Merge(RGB),183,0,183,81,50,18,115,13,183
NCIH2170_TOTAL_HER2_R1_G0_2501_18_Merge.tif (RGB).tif,NCIH2170_TOTAL_HER2_R1_G0_2501_18,155,13,142,33,14,17,124,2,155
NCIH2170_LOW_HER2_R1_G2_24_10_117_Merge(RGB).tif,NCIH2170_LOW_HER2_R1_G2_24_10_117_Merge(RGB),295,5,290,73,42,26,227,5,295
NCIH2170_TOTAL_HER2_R1_G2_24_10_107_Merge(RGB).tif,NCIH2170_TOTAL_HER2_R1_G2_24_10_107_Merge(RGB),134,0,134,87,22,37,75,28,134
NCIH2170_LOW_HER2_R1_G1_2404_78_Merge(RGB).tif,NCIH2170_LOW_HER2_R1_G1_2404_78_Merge(RGB),169,7,162,116,36,43,90,37,169
NCIH2170_HIGH_HER2_R1_G0_2501_63_Merge.tif (RGB).tif,NCIH2170_HIGH_HER2_R1_G0_2501_63,339,28,311,83,34,45,260,4,339
NCIH2170_LOW_HER2_R1_G2_24_10_85_Merge(RGB).tif,NCIH2170_LOW_HER2_R1_G2_24_10_85_Merge(RGB),344,1,343,77,53,18,273,6,344
NCIH2170_TOTAL_HER2_R1_G1_2404_43_Merge(RGB).tif,NCIH2170_TOTAL_HER2_R1_G1_2404_43_Merge(RGB),182,5,177,108,66,18,98,24,182
NCIH2170_HIGH_HER2_R1_G0_2501_45_Merge.tif (RGB).tif,NCIH2170_HIGH_HER2_R1_G0_2501_45,147,13,134,32,15,12,120,5,147
NCIH2170_TOTAL_HER2_R1_G1_2404_96_Merge(RGB).tif,NCIH2170_TOTAL_HER2_R1_G1_2404_96_Merge(RGB),188,13,175,115,51,23,114,41,188
NCIH2170_HIGH_HER2_R1_G1_2404_S2_128_Merge(RGB).tif,NCIH2170_HIGH_HER2_R1_G1_2404_S2_128_Merge(RGB),189,9,180,120,82,25,82,13,189
NCIH2170_HIGH_HER2_R1_G0_2501_3_Merge.tif (RGB).tif,NCIH2170_HIGH_HER2_R1_G0_2501_3,192,8,184,64,1,22,169,41,192
NCIH2170_LOW_HER2_R1_G2_24_10_80_Merge(RGB).tif,NCIH2170_LOW_HER2_R1_G2_24_10_80_Merge(RGB),137,16,121,75,42,23,72,10,137
NCIH2170_HIGH_HER2_R1_G0_2501_21_Merge.tif (RGB).tif,NCIH2170_HIGH_HER2_R1_G0_2501_21,117,5,112,15,6,9,102,0,117
NCIH2170_LOW_HER2_R1_G2_24_10_11A_Merge(RGB).tif,NCIH2170_LOW_HER2_R1_G2_24_10_11A_Merge(RGB),141,13,128,70,36,21,84,13,141
NCIH2170_LOW_HER2_R1_G0_2501_94_Merge.tif (RGB).tif,NCIH2170_LOW_HER2_R1_G0_2501_94,51,0,51,9,2,6,43,1,51
NCIH2170_TOTAL_HER2_R1_G2_24_10_39_Merge(RGB).tif,NCIH2170_TOTAL_HER2_R1_G2_24_10_39_Merge(RGB),245,16,229,116,45,32,168,39,245
NCIH2170_HIGH_HER2_R1_G0_2501_126_Merge.tif (RGB).tif,NCIH2170_HIGH_HER2_R1_G0_2501_126,141,3,138,46,17,23,101,6,141
NCIH2170_LOW_HER2_R1_G2_24_10_109_Merge(RGB).tif,NCIH2170_LOW_HER2_R1_G2_24_10_109_Merge(RGB),124,3,121,33,18,10,96,5,124
NCIH2170_HIGH_HER2_R1_G2_24_10_106_Merge(RGB).tif,NCIH2170_HIGH_HER2_R1_G2_24_10_106_Merge(RGB),483,14,469,118,61,45,377,12,483
NCIH2170_TOTAL_HER2_R1_G1_2404_107_Merge(RGB).tif,NCIH2170_TOTAL_HER2_R1_G1_2404_107_Merge(RGB),63,1,62,42,24,9,30,9,63
NCIH2170_LOW_HER2_R1_G0_2501_122_Merge.tif (RGB).tif,NCIH2170_LOW_HER2_R1_G0_2501_122,68,1,67,35,18,12,38,5,68
NCIH2170_HIGH_HER2_R1_G1_2404_S2_6_Merge(RGB).tif,NCIH2170_HIGH_HER2_R1_G1_2404_S2_6_Merge(RGB),141,0,141,59,25,26,90,8,141
NCIH2170_HIGH_HER2_R1_G0_2501_13_Merge.tif (RGB).tif,NCIH2170_HIGH_HER2_R1_G0_2501_13,177,4,173,88,34,38,105,16,177
NCIH2170_HIGH_HER2_R1_G0_2501_124_Merge.tif (RGB).tif,NCIH2170_HIGH_HER2_R1_G0_2501_124,330,4,326,85,23,56,251,6,330
NCIH2170_LOW_HER2_R1_G1_2404_43_Merge(RGB).tif,NCIH2170_LOW_HER2_R1_G1_2404_43_Merge(RGB),75,1,74,64,39,10,26,15,75
NCIH2170_LOW_HER2_R1_G0_2501_8_Merge.tif (RGB).tif,NCIH2170_LOW_HER2_R1_G0_2501_8,97,0,97,74,1,14,82,59,97
NCIH2170_LOW_HER2_R1_G0_2501_87_Merge.tif (RGB).tif,NCIH2170_LOW_HER2_R1_G0_2501_87,237,5,232,56,21,30,186,5,237
NCIH2170_LOW_HER2_R1_G1_2404_24_Merge(RGB).tif,NCIH2170_LOW_HER2_R1_G1_2404_24_Merge(RGB),222,4,218,60,16,34,172,10,222
NCIH2170_LOW_HER2_R1_G2_24_10_114_Merge(RGB).tif,NCIH2170_LOW_HER2_R1_G2_24_10_114_Merge(RGB),277,3,274,80,38,27,212,15,277
NCIH2170_LOW_HER2_R1_G1_2404_34_Merge(RGB).tif,NCIH2170_LOW_HER2_R1_G1_2404_34_Merge(RGB),140,3,137,115,68,22,50,25,140
NCIH2170_TOTAL_HER2_R1_G0_2501_89_Merge.tif (RGB).tif,NCIH2170_TOTAL_HER2_R1_G0_2501_89,270,1,269,62,18,39,213,5,270
NCIH2170_LOW_HER2_R1_G2_24_10_93A_Merge(RGB).tif,NCIH2170_LOW_HER2_R1_G2_24_10_93A_Merge(RGB),92,2,90,34,16,11,65,7,92
NCIH2170_LOW_HER2_R1_G2_24_10_73_Merge(RGB).tif,NCIH2170_LOW_HER2_R1_G2_24_10_73_Merge(RGB),131,10,121,24,11,9,111,4,131
NCIH2170_TOTAL_HER2_R1_G0_2501_79_Merge.tif (RGB).tif,NCIH2170_TOTAL_HER2_R1_G0_2501_79,134,0,134,40,25,11,98,4,134
NCIH2170_LOW_HER2_R1_G2_24_10_41_Merge(RGB).tif,NCIH2170_LOW_HER2_R1_G2_24_10_41_Merge(RGB),370,1,369,138,57,55,258,26,370
NCIH2170_HIGH_HER2_R1_G1_2404_S2_109_Merge(RGB).tif,NCIH2170_HIGH_HER2_R1_G1_2404_S2_109_Merge(RGB),215,0,215,106,76,15,124,15,215
NCIH2170_HIGH_HER2_R1_G0_2501_112_Merge.tif (RGB).tif,NCIH2170_HIGH_HER2_R1_G0_2501_112,431,25,406,164,62,97,272,5,431
NCIH2170_TOTAL_HER2_R1_G2_24_10_59_Merge(RGB).tif,NCIH2170_TOTAL_HER2_R1_G2_24_10_59_Merge(RGB),585,0,585,241,80,122,383,39,585
NCIH2170_LOW_HER2_R1_G2_24_10_29_Merge(RGB).tif,NCIH2170_LOW_HER2_R1_G2_24_10_29_Merge(RGB),248,3,245,72,41,23,184,8,248
NCIH2170_TOTAL_HER2_R1_G0_2501_26A_Merge.tif (RGB).tif,NCIH2170_TOTAL_HER2_R1_G0_2501_26A,190,0,190,78,36,37,117,5,190
NCIH2170_HIGH_HER2_R1_G2_24_10_55_Merge(RGB).tif,NCIH2170_HIGH_HER2_R1_G2_24_10_55_Merge(RGB),216,10,206,69,35,17,164,17,216
NCIH2170_LOW_HER2_R1_G1_2404_45_Merge(RGB).tif,NCIH2170_LOW_HER2_R1_G1_2404_45_Merge(RGB),121,21,100,53,30,14,77,9,121
NCIH2170_HIGH_HER2_R1_G0_2501_78_Merge.tif (RGB).tif,NCIH2170_HIGH_HER2_R1_G0_2501_78,281,5,276,18,6,11,264,1,281
NCIH2170_TOTAL_HER2_R1_G1_2404_88_Merge(RGB).tif,NCIH2170_TOTAL_HER2_R1_G1_2404_88_Merge(RGB),203,1,202,60,33,18,152,9,203
NCIH2170_HIGH_HER2_R1_G2_24_10_38_Merge(RGB).tif,NCIH2170_HIGH_HER2_R1_G2_24_10_38_Merge(RGB),162,3,159,39,12,24,126,3,162
NCIH2170_LOW_HER2_R1_G0_2501_29_Merge.tif (RGB).tif,NCIH2170_LOW_HER2_R1_G0_2501_29,143,3,140,38,24,11,108,3,143
NCIH2170_LOW_HER2_R1_G1_2404_37_Merge(RGB).tif,NCIH2170_LOW_HER2_R1_G1_2404_37_Merge(RGB),324,5,319,91,50,30,244,11,324
NCIH2170_LOW_HER2_R1_G0_2501_113_Merge.tif (RGB).tif,NCIH2170_LOW_HER2_R1_G0_2501_113,113,0,113,30,14,12,87,4,113
NCIH2170_LOW_HER2_R1_G2_24_10_70_Merge(RGB).tif,NCIH2170_LOW_HER2_R1_G2_24_10_70_Merge(RGB),200,2,198,67,33,30,137,4,200
NCIH2170_TOTAL_HER2_R1_G2_24_10_113_Merge(RGB).tif,NCIH2170_TOTAL_HER2_R1_G2_24_10_113_Merge(RGB),182,1,181,63,31,18,133,14,182
NCIH2170_TOTAL_HER2_R1_G2_24_10_83_Merge(RGB).tif,NCIH2170_TOTAL_HER2_R1_G2_24_10_83_Merge(RGB),252,0,252,44,18,22,212,4,252
NCIH2170_TOTAL_HER2_R1_G0_2501_91_Merge.tif (RGB).tif,NCIH2170_TOTAL_HER2_R1_G0_2501_91,227,1,226,59,15,37,175,7,227
NCIH2170_HIGH_HER2_R1_G2_24_10_28_Merge(RGB).tif,NCIH2170_HIGH_HER2_R1_G2_24_10_28_Merge(RGB),123,6,117,35,14,13,96,8,123
NCIH2170_TOTAL_HER2_R1_G0_2501_45_Merge.tif (RGB).tif,NCIH2170_TOTAL_HER2_R1_G0_2501_45,205,9,196,49,11,36,158,2,205
NCIH2170_LOW_HER2_R1_G1_2404_66_Merge(RGB).tif,NCIH2170_LOW_HER2_R1_G1_2404_66_Merge(RGB),250,2,248,90,53,31,166,6,250
NCIH2170_HIGH_HER2_R1_G1_2404_S2_116_Merge(RGB).tif,NCIH2170_HIGH_HER2_R1_G1_2404_S2_116_Merge(RGB),225,0,225,75,43,28,154,4,225
NCIH2170_HIGH_HER2_R1_G1_2404_S2_34_Merge(RGB).tif,NCIH2170_HIGH_HER2_R1_G1_2404_S2_34_Merge(RGB),328,0,328,227,107,60,161,60,328
NCIH2170_HIGH_HER2_R1_G2_24_10_103_Merge(RGB).tif,NCIH2170_HIGH_HER2_R1_G2_24_10_103_Merge(RGB),187,9,178,43,26,14,147,3,187
NCIH2170_HIGH_HER2_R1_G2_24_10_51_Merge(RGB).tif,NCIH2170_HIGH_HER2_R1_G2_24_10_51_Merge(RGB),95,10,85,29,13,12,70,4,95
NCIH2170_TOTAL_HER2_R1_G1_2404_98_Merge(RGB).tif,NCIH2170_TOTAL_HER2_R1_G1_2404_98_Merge(RGB),71,0,71,91,36,11,24,44,71
NCIH2170_TOTAL_HER2_R1_G0_2501_101_Merge.tif (RGB).tif,NCIH2170_TOTAL_HER2_R1_G0_2501_101,112,0,112,32,14,18,80,0,112
NCIH2170_TOTAL_HER2_R1_G1_2404_4_Merge(RGB).tif,NCIH2170_TOTAL_HER2_R1_G1_2404_4_Merge(RGB),170,0,170,109,39,34,97,36,170
NCIH2170_TOTAL_HER2_R1_G0_2501_54_Merge.tif (RGB).tif,NCIH2170_TOTAL_HER2_R1_G0_2501_54,142,9,133,28,7,17,118,4,142
NCIH2170_LOW_HER2_R1_G2_24_10_61_Merge(RGB).tif,NCIH2170_LOW_HER2_R1_G2_24_10_61_Merge(RGB),99,0,99,61,40,13,46,8,99
NCIH2170_HIGH_HER2_R1_G0_2501_113_Merge.tif (RGB).tif,NCIH2170_HIGH_HER2_R1_G0_2501_113,133,10,123,107,51,33,49,23,133
NCIH2170_HIGH_HER2_R1_G0_2501_7_Merge.tif (RGB).tif,NCIH2170_HIGH_HER2_R1_G0_2501_7,383,5,378,37,0,20,363,17,383
NCIH2170_HIGH_HER2_R1_G2_24_10_86_Merge(RGB).tif,NCIH2170_HIGH_HER2_R1_G2_24_10_86_Merge(RGB),246,1,245,102,41,40,165,21,246
NCIH2170_HIGH_HER2_R1_G1_2404_S2_30_Merge(RGB).tif,NCIH2170_HIGH_HER2_R1_G1_2404_S2_30_Merge(RGB),116,22,94,16,8,8,100,0,116
NCIH2170_TOTAL_HER2_R1_G0_2501_24_Merge.tif (RGB).tif,NCIH2170_TOTAL_HER2_R1_G0_2501_24,225,0,225,59,15,40,170,4,225
NCIH2170_TOTAL_HER2_R1_G1_2404_2_Merge(RGB).tif,NCIH2170_TOTAL_HER2_R1_G1_2404_2_Merge(RGB),59,6,53,20,14,6,39,0,59
NCIH2170_HIGH_HER2_R1_G2_24_10_35_Merge(RGB).tif,NCIH2170_HIGH_HER2_R1_G2_24_10_35_Merge(RGB),190,3,187,60,34,18,138,8,190
NCIH2170_LOW_HER2_R1_G0_2501_66_Merge.tif (RGB).tif,NCIH2170_LOW_HER2_R1_G0_2501_66,102,3,99,33,15,14,73,4,102
NCIH2170_TOTAL_HER2_R1_G2_24_10_98_Merge(RGB).tif,NCIH2170_TOTAL_HER2_R1_G2_24_10_98_Merge(RGB),589,1,588,179,89,74,426,16,589
NCIH2170_LOW_HER2_R1_G2_24_10_121_Merge(RGB).tif,NCIH2170_LOW_HER2_R1_G2_24_10_121_Merge(RGB),194,1,193,62,25,25,144,12,194
NCIH2170_LOW_HER2_R1_G2_24_10_72_Merge(RGB).tif,NCIH2170_LOW_HER2_R1_G2_24_10_72_Merge(RGB),82,16,66,48,29,9,44,10,82
NCIH2170_TOTAL_HER2_R1_G0_2501_26B_Merge.tif (RGB).tif,NCIH2170_TOTAL_HER2_R1_G0_2501_26B,180,0,180,37,10,26,144,1,180
NCIH2170_LOW_HER2_R1_G0_2501_116_Merge.tif (RGB).tif,NCIH2170_LOW_HER2_R1_G0_2501_116,127,6,121,18,6,9,112,3,127
NCIH2170_TOTAL_HER2_R1_G2_24_10_111_Merge(RGB).tif,NCIH2170_TOTAL_HER2_R1_G2_24_10_111_Merge(RGB),326,0,326,199,71,65,190,63,326
NCIH2170_LOW_HER2_R1_G0_2501_78_Merge.tif (RGB).tif,NCIH2170_LOW_HER2_R1_G0_2501_78,211,10,201,45,17,26,168,2,211
NCIH2170_LOW_HER2_R1_G2_24_10_67_Merge(RGB).tif,NCIH2170_LOW_HER2_R1_G2_24_10_67_Merge(RGB),128,22,106,24,9,10,109,5,128
NCIH2170_TOTAL_HER2_R1_G2_24_10_38_Merge(RGB).tif,NCIH2170_TOTAL_HER2_R1_G2_24_10_38_Merge(RGB),293,19,274,51,12,36,245,3,293
NCIH2170_TOTAL_HER2_R1_G0_2501_100_Merge.tif (RGB).tif,NCIH2170_TOTAL_HER2_R1_G0_2501_100,104,8,96,13,8,3,93,2,104
NCIH2170_TOTAL_HER2_R1_G1_2404_13_Merge(RGB).tif,NCIH2170_TOTAL_HER2_R1_G1_2404_13_Merge(RGB),40,9,31,9,4,1,35,4,40
NCIH2170_HIGH_HER2_R1_G0_2501_46_Merge.tif (RGB).tif,NCIH2170_HIGH_HER2_R1_G0_2501_46,116,4,112,37,17,17,82,3,116
NCIH2170_LOW_HER2_R1_G2_24_10_19_Merge(RGB).tif,NCIH2170_LOW_HER2_R1_G2_24_10_19_Merge(RGB),223,4,219,77,49,16,158,12,223
NCIH2170_HIGH_HER2_R1_G0_2501_47_Merge.tif (RGB).tif,NCIH2170_HIGH_HER2_R1_G0_2501_47,55,2,53,29,16,8,31,5,55
NCIH2170_HIGH_HER2_R1_G0_2501_11_Merge.tif (RGB).tif,NCIH2170_HIGH_HER2_R1_G0_2501_11,251,0,251,30,1,10,240,19,251
NCIH2170_HIGH_HER2_R1_G2_24_10_65_Merge(RGB).tif,NCIH2170_HIGH_HER2_R1_G2_24_10_65_Merge(RGB),367,13,354,173,85,68,214,20,367
NCIH2170_LOW_HER2_R1_G1_2404_46_Merge(RGB).tif,NCIH2170_LOW_HER2_R1_G1_2404_46_Merge(RGB),143,23,120,59,36,17,90,6,143
NCIH2170_LOW_HER2_R1_G2_24_10_3_Merge(RGB).tif,NCIH2170_LOW_HER2_R1_G2_24_10_3_Merge(RGB),142,5,137,64,38,16,88,10,142
NCIH2170_HIGH_HER2_R1_G2_24_10_105B_Merge(RGB).tif,NCIH2170_HIGH_HER2_R1_G2_24_10_105B_Merge(RGB),155,5,150,83,51,24,80,8,155
NCIH2170_TOTAL_HER2_R1_G0_2501_119_Merge.tif (RGB).tif,NCIH2170_TOTAL_HER2_R1_G0_2501_119,159,5,154,43,14,26,119,3,159
NCIH2170_HIGH_HER2_R1_G2_24_10_17_Merge(RGB).tif,NCIH2170_HIGH_HER2_R1_G2_24_10_17_Merge(RGB),546,7,539,383,117,134,295,132,546
NCIH2170_HIGH_HER2_R1_G2_24_10_123_Merge(RGB).tif,NCIH2170_HIGH_HER2_R1_G2_24_10_123_Merge(RGB),137,5,132,71,13,33,91,25,137
NCIH2170_LOW_HER2_R1_G0_2501_12A_Merge.tif (RGB).tif,NCIH2170_LOW_HER2_R1_G0_2501_12A,105,12,93,33,21,10,74,2,105
NCIH2170_TOTAL_HER2_R1_G2_24_10_78_Merge(RGB).tif,NCIH2170_TOTAL_HER2_R1_G2_24_10_78_Merge(RGB),524,1,523,165,71,86,367,8,524
NCIH2170_LOW_HER2_R1_G1_2404_49_Merge(RGB).tif,NCIH2170_LOW_HER2_R1_G1_2404_49_Merge(RGB),219,1,218,200,99,57,63,44,219
NCIH2170_TOTAL_HER2_R1_G1_2404_73_Merge(RGB).tif,NCIH2170_TOTAL_HER2_R1_G1_2404_73_Merge(RGB),81,6,75,24,10,8,63,6,81
NCIH2170_HIGH_HER2_R1_G1_2404_S2_44_Merge(RGB).tif,NCIH2170_HIGH_HER2_R1_G1_2404_S2_44_Merge(RGB),378,0,378,140,61,48,269,31,378
NCIH2170_HIGH_HER2_R1_G1_2404_S2_84_Merge(RGB).tif,NCIH2170_HIGH_HER2_R1_G1_2404_S2_84_Merge(RGB),438,9,429,325,209,59,170,57,438
NCIH2170_HIGH_HER2_R1_G1_2404_S2_82_Merge(RGB).tif,NCIH2170_HIGH_HER2_R1_G1_2404_S2_82_Merge(RGB),161,0,161,170,64,38,59,68,161
NCIH2170_TOTAL_HER2_R1_G1_2404_30_Merge(RGB).tif,NCIH2170_TOTAL_HER2_R1_G1_2404_30_Merge(RGB),297,0,297,186,114,58,125,14,297
NCIH2170_HIGH_HER2_R1_G0_2501_105_Merge.tif (RGB).tif,NCIH2170_HIGH_HER2_R1_G0_2501_105,144,0,144,31,15,16,113,0,144
NCIH2170_LOW_HER2_R1_G1_2404_33_Merge(RGB).tif,NCIH2170_LOW_HER2_R1_G1_2404_33_Merge(RGB),232,3,229,157,71,52,109,34,232
NCIH2170_LOW_HER2_R1_G2_24_10_12_Merge(RGB).tif,NCIH2170_LOW_HER2_R1_G2_24_10_12_Merge(RGB),312,5,307,89,55,25,232,9,312
NCIH2170_HIGH_HER2_R1_G1_2404_S2_21_Merge(RGB).tif,NCIH2170_HIGH_HER2_R1_G1_2404_S2_21_Merge(RGB),234,58,176,51,21,24,189,6,234
NCIH2170_HIGH_HER2_R1_G0_2501_31_Merge.tif (RGB).tif,NCIH2170_HIGH_HER2_R1_G0_2501_31,147,1,146,77,34,27,86,16,147
NCIH2170_TOTAL_HER2_R1_G2_24_10_88_Merge(RGB).tif,NCIH2170_TOTAL_HER2_R1_G2_24_10_88_Merge(RGB),181,0,181,85,61,18,102,6,181
NCIH2170_LOW_HER2_R1_G0_2501_103_Merge.tif (RGB).tif,NCIH2170_LOW_HER2_R1_G0_2501_103,194,17,177,71,21,32,141,18,194
NCIH2170_LOW_HER2_R1_G1_2404_62_Merge(RGB).tif,NCIH2170_LOW_HER2_R1_G1_2404_62_Merge(RGB),217,2,215,119,40,54,123,25,217
NCIH2170_TOTAL_HER2_R1_G2_24_10_54_Merge(RGB).tif,NCIH2170_TOTAL_HER2_R1_G2_24_10_54_Merge(RGB),272,19,253,124,57,41,174,26,272
NCIH2170_TOTAL_HER2_R1_G2_24_10_94_Merge(RGB).tif,NCIH2170_TOTAL_HER2_R1_G2_24_10_94_Merge(RGB),304,1,303,64,30,27,247,7,304
NCIH2170_LOW_HER2_R1_G2_24_10_64_Merge(RGB).tif,NCIH2170_LOW_HER2_R1_G2_24_10_64_Merge(RGB),597,8,589,127,59,59,479,9,597
NCIH2170_TOTAL_HER2_R1_G2_24_10_68_Merge(RGB).tif,NCIH2170_TOTAL_HER2_R1_G2_24_10_68_Merge(RGB),402,0,402,102,31,54,317,17,402
NCIH2170_HIGH_HER2_R1_G0_2501_76_Merge.tif (RGB).tif,NCIH2170_HIGH_HER2_R1_G0_2501_76,131,12,119,17,7,9,115,1,131
NCIH2170_TOTAL_HER2_R1_G0_2501_109A_Merge.tif (RGB).tif,NCIH2170_TOTAL_HER2_R1_G0_2501_109A,255,0,255,63,14,48,193,1,255
NCIH2170_TOTAL_HER2_R1_G1_2404_114_Merge(RGB).tif,NCIH2170_TOTAL_HER2_R1_G1_2404_114_Merge(RGB),221,4,217,104,61,24,136,19,221
NCIH2170_HIGH_HER2_R1_G1_2404_S2_25_Merge(RGB).tif,NCIH2170_HIGH_HER2_R1_G1_2404_S2_25_Merge(RGB),122,5,117,71,36,22,64,13,122
NCIH2170_HIGH_HER2_R1_G2_24_10_97_Merge(RGB).tif,NCIH2170_HIGH_HER2_R1_G2_24_10_97_Merge(RGB),202,42,160,131,74,33,95,24,202
NCIH2170_HIGH_HER2_R1_G0_2501_4_Merge.tif (RGB).tif,NCIH2170_HIGH_HER2_R1_G0_2501_4,198,7,191,32,0,15,183,17,198
NCIH2170_HIGH_HER2_R1_G0_2501_104_Merge.tif (RGB).tif,NCIH2170_HIGH_HER2_R1_G0_2501_104,281,14,267,54,22,29,230,3,281
NCIH2170_HIGH_HER2_R1_G2_24_10_70_Merge(RGB).tif,NCIH2170_HIGH_HER2_R1_G2_24_10_70_Merge(RGB),115,3,112,42,16,18,81,8,115
NCIH2170_TOTAL_HER2_R1_G0_2501_7_Merge.tif (RGB).tif,NCIH2170_TOTAL_HER2_R1_G0_2501_7,154,15,139,37,0,21,133,16,154
NCIH2170_HIGH_HER2_R1_G0_2501_84_Merge.tif (RGB).tif,NCIH2170_HIGH_HER2_R1_G0_2501_84,195,2,193,49,13,31,151,5,195
NCIH2170_TOTAL_HER2_R1_G2_24_10_99_Merge(RGB).tif,NCIH2170_TOTAL_HER2_R1_G2_24_10_99_Merge(RGB),561,2,559,166,30,111,420,25,561
NCIH2170_HIGH_HER2_R1_G1_2404_S2_26_Merge(RGB).tif,NCIH2170_HIGH_HER2_R1_G1_2404_S2_26_Merge(RGB),419,14,405,196,95,61,263,40,419
NCIH2170_TOTAL_HER2_R1_G2_24_10_105_Merge(RGB).tif,NCIH2170_TOTAL_HER2_R1_G2_24_10_105_Merge(RGB),436,1,435,72,21,46,369,5,436
NCIH2170_LOW_HER2_R1_G0_2501_13_Merge.tif (RGB).tif,NCIH2170_LOW_HER2_R1_G0_2501_13,228,5,223,101,50,44,134,7,228
NCIH2170_LOW_HER2_R1_G2_24_10_14_Merge(RGB).tif,NCIH2170_LOW_HER2_R1_G2_24_10_14_Merge(RGB),89,9,80,50,40,6,43,4,89
NCIH2170_TOTAL_HER2_R1_G0_2501_108_Merge.tif (RGB).tif,NCIH2170_TOTAL_HER2_R1_G0_2501_108,178,0,178,39,19,17,142,3,178
NCIH2170_TOTAL_HER2_R1_G2_24_10_57_Merge(RGB).tif,NCIH2170_TOTAL_HER2_R1_G2_24_10_57_Merge(RGB),486,2,484,182,77,79,330,26,486
NCIH2170_LOW_HER2_R1_G2_24_10_58_Merge(RGB).tif,NCIH2170_LOW_HER2_R1_G2_24_10_58_Merge(RGB),703,0,703,286,193,60,450,33,703
NCIH2170_TOTAL_HER2_R1_G0_2501_5_Merge.tif (RGB).tif,NCIH2170_TOTAL_HER2_R1_G0_2501_5,126,9,117,42,0,5,121,37,126
NCIH2170_LOW_HER2_R1_G1_2404_64_Merge(RGB).tif,NCIH2170_LOW_HER2_R1_G1_2404_64_Merge(RGB),182,3,179,100,54,30,98,16,182
NCIH2170_LOW_HER2_R1_G0_2501_101_Merge.tif (RGB).tif,NCIH2170_LOW_HER2_R1_G0_2501_101,206,0,206,74,30,31,145,13,206
NCIH2170_HIGH_HER2_R1_G2_24_10_92_Merge(RGB).tif,NCIH2170_HIGH_HER2_R1_G2_24_10_92_Merge(RGB),144,38,106,89,34,26,84,29,144
NCIH2170_TOTAL_HER2_R1_G2_24_10_47_Merge(RGB).tif,NCIH2170_TOTAL_HER2_R1_G2_24_10_47_Merge(RGB),164,1,163,64,29,28,107,7,164
NCIH2170_TOTAL_HER2_R1_G1_2404_23_Merge(RGB).tif,NCIH2170_TOTAL_HER2_R1_G1_2404_23_Merge(RGB),212,4,208,139,71,37,104,31,212
NCIH2170_LOW_HER2_R1_G0_2501_85_Merge.tif (RGB).tif,NCIH2170_LOW_HER2_R1_G0_2501_85,175,6,169,22,2,16,157,4,175
NCIH2170_HIGH_HER2_R1_G0_2501_30_Merge.tif (RGB).tif,NCIH2170_HIGH_HER2_R1_G0_2501_30,283,2,281,80,19,51,213,10,283
NCIH2170_TOTAL_HER2_R1_G1_2404_40_Merge(RGB).tif,NCIH2170_TOTAL_HER2_R1_G1_2404_40_Merge(RGB),133,14,119,66,43,16,74,7,133
NCIH2170_TOTAL_HER2_R1_G2_24_10_50_Merge(RGB).tif,NCIH2170_TOTAL_HER2_R1_G2_24_10_50_Merge(RGB),166,12,154,64,15,25,126,24,166
NCIH2170_TOTAL_HER2_R1_G1_2404_62_Merge(RGB).tif,NCIH2170_TOTAL_HER2_R1_G1_2404_62_Merge(RGB),87,2,85,68,50,9,28,9,87
NCIH2170_LOW_HER2_R1_G0_2501_128_Merge.tif (RGB).tif,NCIH2170_LOW_HER2_R1_G0_2501_128,212,19,193,31,11,18,183,2,212
NCIH2170_HIGH_HER2_R1_G0_2501_54_Merge.tif (RGB).tif,NCIH2170_HIGH_HER2_R1_G0_2501_54,227,18,209,23,6,17,204,0,227
NCIH2170_HIGH_HER2_R1_G2_24_10_42_Merge(RGB).tif,NCIH2170_HIGH_HER2_R1_G2_24_10_42_Merge(RGB),132,8,124,74,37,22,73,15,132
NCIH2170_HIGH_HER2_R1_G1_2404_S2_107_Merge(RGB).tif,NCIH2170_HIGH_HER2_R1_G1_2404_S2_107_Merge(RGB),147,0,147,94,70,16,61,8,147
NCIH2170_LOW_HER2_R1_G0_2501_18_Merge.tif (RGB).tif,NCIH2170_LOW_HER2_R1_G0_2501_18,354,3,351,159,43,107,204,9,354
NCIH2170_LOW_HER2_R1_G0_2501_65_Merge.tif (RGB).tif,NCIH2170_LOW_HER2_R1_G0_2501_65,132,6,126,16,9,6,117,1,132
NCIH2170_TOTAL_HER2_R1_G2_24_10_128_Merge(RGB).tif,NCIH2170_TOTAL_HER2_R1_G2_24_10_128_Merge(RGB),402,0,402,136,83,51,268,2,402
NCIH2170_LOW_HER2_R1_G0_2501_97_Merge.tif (RGB).tif,NCIH2170_LOW_HER2_R1_G0_2501_97,127,0,127,62,31,17,79,14,127
NCIH2170_TOTAL_HER2_R1_G2_24_10_35_Merge(RGB).tif,NCIH2170_TOTAL_HER2_R1_G2_24_10_35_Merge(RGB),324,9,315,69,13,47,264,9,324
NCIH2170_HIGH_HER2_R1_G1_2404_S2_72_Merge(RGB).tif,NCIH2170_HIGH_HER2_R1_G1_2404_S2_72_Merge(RGB),421,16,405,75,28,41,352,6,421
NCIH2170_LOW_HER2_R1_G2_24_10_6_Merge(RGB).tif,NCIH2170_LOW_HER2_R1_G2_24_10_6_Merge(RGB),159,3,156,24,13,11,135,0,159
NCIH2170_TOTAL_HER2_R1_G0_2501_73_Merge.tif (RGB).tif,NCIH2170_TOTAL_HER2_R1_G0_2501_73,211,0,211,72,36,28,147,8,211
NCIH2170_HIGH_HER2_R1_G0_2501_103_Merge.tif (RGB).tif,NCIH2170_HIGH_HER2_R1_G0_2501_103,132,4,128,44,18,20,94,6,132
NCIH2170_TOTAL_HER2_R1_G2_24_10_41_Merge(RGB).tif,NCIH2170_TOTAL_HER2_R1_G2_24_10_41_Merge(RGB),114,0,114,48,23,9,82,16,114
NCIH2170_HIGH_HER2_R1_G1_2404_S2_127_Merge(RGB).tif,NCIH2170_HIGH_HER2_R1_G1_2404_S2_127_Merge(RGB),107,1,106,79,38,16,53,25,107
NCIH2170_HIGH_HER2_R1_G1_2404_S2_101_Merge(RGB).tif,NCIH2170_HIGH_HER2_R1_G1_2404_S2_101_Merge(RGB),169,0,169,74,35,21,113,18,169
NCIH2170_HIGH_HER2_R1_G2_24_10_126_Merge(RGB).tif,NCIH2170_HIGH_HER2_R1_G2_24_10_126_Merge(RGB),202,8,194,64,10,42,150,12,202
NCIH2170_HIGH_HER2_R1_G2_24_10_116_Merge(RGB).tif,NCIH2170_HIGH_HER2_R1_G2_24_10_116_Merge(RGB),375,4,371,90,43,40,292,7,375
NCIH2170_LOW_HER2_R1_G1_2404_82_Merge(RGB).tif,NCIH2170_LOW_HER2_R1_G1_2404_82_Merge(RGB),229,15,214,193,61,68,100,64,229
NCIH2170_HIGH_HER2_R1_G2_24_10_61_Merge(RGB).tif,NCIH2170_HIGH_HER2_R1_G2_24_10_61_Merge(RGB),154,20,134,59,17,18,119,24,154
NCIH2170_HIGH_HER2_R1_G1_2404_S2_20_Merge(RGB).tif,NCIH2170_HIGH_HER2_R1_G1_2404_S2_20_Merge(RGB),299,1,298,192,117,51,131,24,299
NCIH2170_TOTAL_HER2_R1_G0_2501_52_Merge.tif (RGB).tif,NCIH2170_TOTAL_HER2_R1_G0_2501_52,124,1,123,21,10,8,106,3,124
NCIH2170_TOTAL_HER2_R1_G0_2501_31_Merge.tif (RGB).tif,NCIH2170_TOTAL_HER2_R1_G0_2501_31,172,1,171,41,23,17,132,1,172
NCIH2170_HIGH_HER2_R1_G2_24_10_108B_Merge(RGB).tif,NCIH2170_HIGH_HER2_R1_G2_24_10_108B_Merge(RGB),58,1,57,28,13,8,37,7,58
NCIH2170_TOTAL_HER2_R1_G2_24_10_122_Merge(RGB).tif,NCIH2170_TOTAL_HER2_R1_G2_24_10_122_Merge(RGB),432,1,431,122,84,27,321,11,432
NCIH2170_TOTAL_HER2_R1_G1_2404_52_Merge(RGB).tif,NCIH2170_TOTAL_HER2_R1_G1_2404_52_Merge(RGB),194,2,192,134,81,29,84,24,194
NCIH2170_HIGH_HER2_R1_G0_2501_79_Merge.tif (RGB).tif,NCIH2170_HIGH_HER2_R1_G0_2501_79,252,3,249,90,37,41,174,12,252
NCIH2170_TOTAL_HER2_R1_G2_24_10_9_Merge(RGB).tif,NCIH2170_TOTAL_HER2_R1_G2_24_10_9_Merge(RGB),450,1,449,134,28,82,340,24,450
NCIH2170_TOTAL_HER2_R1_G0_2501_70_Merge.tif (RGB).tif,NCIH2170_TOTAL_HER2_R1_G0_2501_70,170,0,170,94,52,31,87,11,170
NCIH2170_HIGH_HER2_R1_G2_24_10_84_Merge(RGB).tif,NCIH2170_HIGH_HER2_R1_G2_24_10_84_Merge(RGB),141,15,126,30,12,13,116,5,141
NCIH2170_TOTAL_HER2_R1_G0_2501_57_Merge.tif (RGB).tif,NCIH2170_TOTAL_HER2_R1_G0_2501_57,187,0,187,66,21,35,131,10,187
NCIH2170_LOW_HER2_R1_G2_24_10_62_Merge(RGB).tif,NCIH2170_LOW_HER2_R1_G2_24_10_62_Merge(RGB),154,24,130,65,41,12,101,12,154
NCIH2170_TOTAL_HER2_R1_G0_2501_114A_Merge.tif (RGB).tif,NCIH2170_TOTAL_HER2_R1_G0_2501_114A,181,8,173,74,27,40,114,7,181
NCIH2170_TOTAL_HER2_R1_G2_24_10_27_Merge(RGB).tif,NCIH2170_TOTAL_HER2_R1_G2_24_10_27_Merge(RGB),66,7,59,39,19,12,35,8,66
NCIH2170_HIGH_HER2_R1_G0_2501_43_Merge.tif (RGB).tif,NCIH2170_HIGH_HER2_R1_G0_2501_43,229,2,227,58,16,38,175,4,229
NCIH2170_TOTAL_HER2_R1_G0_2501_117_Merge.tif (RGB).tif,NCIH2170_TOTAL_HER2_R1_G0_2501_117,236,11,225,46,23,23,190,0,236
NCIH2170_HIGH_HER2_R1_G1_2404_S2_92_Merge(RGB).tif,NCIH2170_HIGH_HER2_R1_G1_2404_S2_92_Merge(RGB),87,0,87,16,12,4,71,0,87
NCIH2170_LOW_HER2_R1_G0_2501_43_Merge.tif (RGB).tif,NCIH2170_LOW_HER2_R1_G0_2501_43,100,1,99,53,19,19,62,15,100
NCIH2170_LOW_HER2_R1_G0_2501_48_Merge.tif (RGB).tif,NCIH2170_LOW_HER2_R1_G0_2501_48,130,8,122,59,29,22,79,8,130
NCIH2170_LOW_HER2_R1_G1_2404_76_Merge(RGB).tif,NCIH2170_LOW_HER2_R1_G1_2404_76_Merge(RGB),157,3,154,133,51,37,69,45,157
NCIH2170_HIGH_HER2_R1_G2_24_10_80_Merge(RGB).tif,NCIH2170_HIGH_HER2_R1_G2_24_10_80_Merge(RGB),230,12,218,64,17,44,169,3,230
NCIH2170_HIGH_HER2_R1_G1_2404_S2_52_Merge(RGB).tif,NCIH2170_HIGH_HER2_R1_G1_2404_S2_52_Merge(RGB),117,4,113,51,21,22,74,8,117
NCIH2170_TOTAL_HER2_R1_G0_2501_61_Merge.tif (RGB).tif,NCIH2170_TOTAL_HER2_R1_G0_2501_61,227,0,227,89,35,48,144,6,227
NCIH2170_HIGH_HER2_R1_G1_2404_S2_12_Merge(RGB).tif,NCIH2170_HIGH_HER2_R1_G1_2404_S2_12_Merge(RGB),238,10,228,111,51,34,153,26,238
NCIH2170_HIGH_HER2_R1_G0_2501_69_Merge.tif (RGB).tif,NCIH2170_HIGH_HER2_R1_G0_2501_69,137,5,132,55,20,24,93,11,137
NCIH2170_TOTAL_HER2_R1_G1_2404_91_Merge(RGB).tif,NCIH2170_TOTAL_HER2_R1_G1_2404_91_Merge(RGB),157,14,143,59,30,21,106,8,157
NCIH2170_HIGH_HER2_R1_G1_2404_S2_19_Merge(RGB).tif,NCIH2170_HIGH_HER2_R1_G1_2404_S2_19_Merge(RGB),89,4,85,53,16,17,56,20,89
NCIH2170_LOW_HER2_R1_G2_24_10_93B_Merge(RGB).tif,NCIH2170_LOW_HER2_R1_G2_24_10_93B_Merge(RGB),162,0,162,68,30,24,108,14,162
NCIH2170_TOTAL_HER2_R1_G1_2404_65_Merge(RGB).tif,NCIH2170_TOTAL_HER2_R1_G1_2404_65_Merge(RGB),143,2,141,130,64,24,55,42,143
NCIH2170_TOTAL_HER2_R1_G2_24_10_43_Merge(RGB).tif,NCIH2170_TOTAL_HER2_R1_G2_24_10_43_Merge(RGB),247,34,213,65,37,19,191,9,247
NCIH2170_TOTAL_HER2_R1_G1_2404_20_Merge(RGB).tif,NCIH2170_TOTAL_HER2_R1_G1_2404_20_Merge(RGB),156,2,154,143,85,22,49,36,156
NCIH2170_HIGH_HER2_R1_G0_2501_15B_Merge.tif (RGB).tif,NCIH2170_HIGH_HER2_R1_G0_2501_15B,143,2,141,90,57,22,64,11,143
NCIH2170_HIGH_HER2_R1_G2_24_10_100_Merge(RGB).tif,NCIH2170_HIGH_HER2_R1_G2_24_10_100_Merge(RGB),121,33,88,79,33,32,56,14,121
NCIH2170_TOTAL_HER2_R1_G0_2501_76_Merge.tif (RGB).tif,NCIH2170_TOTAL_HER2_R1_G0_2501_76,241,6,235,44,13,25,203,6,241
NCIH2170_HIGH_HER2_R1_G1_2404_S2_125_Merge(RGB).tif,NCIH2170_HIGH_HER2_R1_G1_2404_S2_125_Merge(RGB),70,1,69,38,16,11,43,11,70
NCIH2170_TOTAL_HER2_R1_G0_2501_62_Merge.tif (RGB).tif,NCIH2170_TOTAL_HER2_R1_G0_2501_62,289,4,285,85,29,54,206,2,289
NCIH2170_HIGH_HER2_R1_G1_2404_S2_95_Merge(RGB).tif,NCIH2170_HIGH_HER2_R1_G1_2404_S2_95_Merge(RGB),124,0,124,43,27,10,87,6,124
NCIH2170_HIGH_HER2_R1_G0_2501_95_Merge.tif (RGB).tif,NCIH2170_HIGH_HER2_R1_G0_2501_95,152,2,150,51,8,25,119,18,152
NCIH2170_TOTAL_HER2_R1_G2_24_10_91_Merge(RGB).tif,NCIH2170_TOTAL_HER2_R1_G2_24_10_91_Merge(RGB),481,0,481,14,3,9,469,2,481
NCIH2170_HIGH_HER2_R1_G1_2404_S2_74_Merge(RGB).tif,NCIH2170_HIGH_HER2_R1_G1_2404_S2_74_Merge(RGB),118,0,118,62,26,18,74,18,118
NCIH2170_HIGH_HER2_R1_G1_2404_S2_59_Merge(RGB).tif,NCIH2170_HIGH_HER2_R1_G1_2404_S2_59_Merge(RGB),157,16,141,53,26,20,111,7,157
NCIH2170_TOTAL_HER2_R1_G1_2404_14_Merge(RGB).tif,NCIH2170_TOTAL_HER2_R1_G1_2404_14_Merge(RGB),82,0,82,97,38,16,28,43,82
NCIH2170_LOW_HER2_R1_G2_24_10_86_Merge(RGB).tif,NCIH2170_LOW_HER2_R1_G2_24_10_86_Merge(RGB),174,0,174,113,55,45,74,13,174
NCIH2170_HIGH_HER2_R1_G2_24_10_93_Merge(RGB).tif,NCIH2170_HIGH_HER2_R1_G2_24_10_93_Merge(RGB),277,32,245,166,62,77,138,27,277
NCIH2170_LOW_HER2_R1_G1_2404_17_Merge(RGB).tif,NCIH2170_LOW_HER2_R1_G1_2404_17_Merge(RGB),139,2,137,98,35,29,75,34,139
NCIH2170_LOW_HER2_R1_G2_24_10_100_Merge(RGB).tif,NCIH2170_LOW_HER2_R1_G2_24_10_100_Merge(RGB),194,6,188,59,32,18,144,9,194
NCIH2170_HIGH_HER2_R1_G2_24_10_16_Merge(RGB).tif,NCIH2170_HIGH_HER2_R1_G2_24_10_16_Merge(RGB),384,15,369,124,91,27,266,6,384
NCIH2170_LOW_HER2_R1_G2_24_10_13_Merge(RGB).tif,NCIH2170_LOW_HER2_R1_G2_24_10_13_Merge(RGB),161,14,147,36,11,17,133,8,161
NCIH2170_LOW_HER2_R1_G2_24_10_92_Merge(RGB).tif,NCIH2170_LOW_HER2_R1_G2_24_10_92_Merge(RGB),151,16,135,37,20,6,125,11,151
NCIH2170_HIGH_HER2_R1_G1_2404_S2_113_Merge(RGB).tif,NCIH2170_HIGH_HER2_R1_G1_2404_S2_113_Merge(RGB),411,1,410,278,103,120,188,55,411
NCIH2170_HIGH_HER2_R1_G0_2501_86_Merge.tif (RGB).tif,NCIH2170_HIGH_HER2_R1_G0_2501_86,236,3,233,49,15,30,191,4,236
NCIH2170_HIGH_HER2_R1_G2_24_10_88_Merge(RGB).tif,NCIH2170_HIGH_HER2_R1_G2_24_10_88_Merge(RGB),164,12,152,58,30,26,108,2,164
NCIH2170_TOTAL_HER2_R1_G2_24_10_118_Merge(RGB).tif,NCIH2170_TOTAL_HER2_R1_G2_24_10_118_Merge(RGB),94,0,94,43,21,17,56,5,94
NCIH2170_HIGH_HER2_R1_G2_24_10_98_Merge(RGB).tif,NCIH2170_HIGH_HER2_R1_G2_24_10_98_Merge(RGB),273,42,231,230,101,74,98,55,273
NCIH2170_LOW_HER2_R1_G2_24_10_38_Merge(RGB).tif,NCIH2170_LOW_HER2_R1_G2_24_10_38_Merge(RGB),79,9,70,66,19,8,52,39,79
NCIH2170_LOW_HER2_R1_G0_2501_77_Merge.tif (RGB).tif,NCIH2170_LOW_HER2_R1_G0_2501_77,239,6,233,49,12,30,197,7,239
NCIH2170_HIGH_HER2_R1_G1_2404_S2_129_Merge(RGB).tif,NCIH2170_HIGH_HER2_R1_G1_2404_S2_129_Merge(RGB),341,11,330,159,104,33,204,22,341
NCIH2170_HIGH_HER2_R1_G0_2501_83_Merge.tif (RGB).tif,NCIH2170_HIGH_HER2_R1_G0_2501_83,137,0,137,72,48,18,71,6,137
NCIH2170_HIGH_HER2_R1_G0_2501_68_Merge.tif (RGB).tif,NCIH2170_HIGH_HER2_R1_G0_2501_68,217,6,211,37,7,27,183,3,217
NCIH2170_HIGH_HER2_R1_G0_2501_60_Merge.tif (RGB).tif,NCIH2170_HIGH_HER2_R1_G0_2501_60,347,0,347,119,53,50,244,16,347
NCIH2170_TOTAL_HER2_R1_G0_2501_118_Merge.tif (RGB).tif,NCIH2170_TOTAL_HER2_R1_G0_2501_118,73,4,69,25,4,14,55,7,73
NCIH2170_HIGH_HER2_R1_G0_2501_22_Merge.tif (RGB).tif,NCIH2170_HIGH_HER2_R1_G0_2501_22,280,2,278,52,25,26,229,1,280
NCIH2170_HIGH_HER2_R1_G2_24_10_87_Merge(RGB).tif,NCIH2170_HIGH_HER2_R1_G2_24_10_87_Merge(RGB),271,4,267,74,48,22,201,4,271
NCIH2170_HIGH_HER2_R1_G2_24_10_115_Merge(RGB).tif,NCIH2170_HIGH_HER2_R1_G2_24_10_115_Merge(RGB),191,1,190,59,35,18,138,6,191
NCIH2170_TOTAL_HER2_R1_G0_2501_105_Merge.tif (RGB).tif,NCIH2170_TOTAL_HER2_R1_G0_2501_105,128,2,126,46,23,18,87,5,128
NCIH2170_LOW_HER2_R1_G0_2501_120_Merge.tif (RGB).tif,NCIH2170_LOW_HER2_R1_G0_2501_120,217,7,210,48,21,24,172,3,217
NCIH2170_LOW_HER2_R1_G1_2404_38_Merge(RGB).tif,NCIH2170_LOW_HER2_R1_G1_2404_38_Merge(RGB),120,12,108,88,43,29,48,16,120
NCIH2170_TOTAL_HER2_R1_G2_24_10_18_Merge(RGB).tif,NCIH2170_TOTAL_HER2_R1_G2_24_10_18_Merge(RGB),318,0,318,66,30,28,260,8,318
NCIH2170_TOTAL_HER2_R1_G1_2404_58_Merge(RGB).tif,NCIH2170_TOTAL_HER2_R1_G1_2404_58_Merge(RGB),204,0,204,147,51,38,115,58,204
NCIH2170_LOW_HER2_R1_G0_2501_20_Merge.tif (RGB).tif,NCIH2170_LOW_HER2_R1_G0_2501_20,74,7,67,14,6,8,60,0,74
NCIH2170_LOW_HER2_R1_G1_2404_32_Merge(RGB).tif,NCIH2170_LOW_HER2_R1_G1_2404_32_Merge(RGB),308,2,306,193,39,85,184,69,308
NCIH2170_HIGH_HER2_R1_G0_2501_109_Merge.tif (RGB).tif,NCIH2170_HIGH_HER2_R1_G0_2501_109,410,2,408,93,49,37,324,7,410
NCIH2170_LOW_HER2_R1_G0_2501_28_Merge.tif (RGB).tif,NCIH2170_LOW_HER2_R1_G0_2501_28,165,10,155,70,38,29,98,3,165
NCIH2170_HIGH_HER2_R1_G1_2404_S2_31_Merge(RGB).tif,NCIH2170_HIGH_HER2_R1_G1_2404_S2_31_Merge(RGB),247,19,228,33,18,15,214,0,247
NCIH2170_TOTAL_HER2_R1_G0_2501_103_Merge.tif (RGB).tif,NCIH2170_TOTAL_HER2_R1_G0_2501_103,127,0,127,42,21,14,92,7,127
NCIH2170_TOTAL_HER2_R1_G1_2404_48_Merge(RGB).tif,NCIH2170_TOTAL_HER2_R1_G1_2404_48_Merge(RGB),170,0,170,77,37,32,101,8,170
NCIH2170_TOTAL_HER2_R1_G2_24_10_25_Merge(RGB).tif,NCIH2170_TOTAL_HER2_R1_G2_24_10_25_Merge(RGB),213,0,213,113,41,45,127,27,213
NCIH2170_LOW_HER2_R1_G2_24_10_40_Merge(RGB).tif,NCIH2170_LOW_HER2_R1_G2_24_10_40_Merge(RGB),81,4,77,24,6,11,64,7,81
NCIH2170_HIGH_HER2_R1_G0_2501_71_Merge.tif (RGB).tif,NCIH2170_HIGH_HER2_R1_G0_2501_71,342,0,342,123,43,69,230,11,342
NCIH2170_HIGH_HER2_R1_G2_24_10_62_Merge(RGB).tif,NCIH2170_HIGH_HER2_R1_G2_24_10_62_Merge(RGB),236,8,228,85,42,31,163,12,236
NCIH2170_TOTAL_HER2_R1_G1_2404_106_Merge(RGB).tif,NCIH2170_TOTAL_HER2_R1_G1_2404_106_Merge(RGB),224,20,204,184,86,47,91,51,224
NCIH2170_HIGH_HER2_R1_G1_2404_S2_57_Merge(RGB).tif,NCIH2170_HIGH_HER2_R1_G1_2404_S2_57_Merge(RGB),440,0,440,236,97,83,260,56,440
NCIH2170_HIGH_HER2_R1_G2_24_10_9_Merge(RGB).tif,NCIH2170_HIGH_HER2_R1_G2_24_10_9_Merge(RGB),320,11,309,149,101,31,188,17,320
NCIH2170_HIGH_HER2_R1_G1_2404_S2_41_Merge(RGB).tif,NCIH2170_HIGH_HER2_R1_G1_2404_S2_41_Merge(RGB),260,55,205,60,26,24,210,10,260
NCIH2170_TOTAL_HER2_R1_G1_2404_120_Merge(RGB).tif,NCIH2170_TOTAL_HER2_R1_G1_2404_120_Merge(RGB),260,2,258,160,84,31,145,45,260
NCIH2170_LOW_HER2_R1_G2_24_10_123_Merge(RGB).tif,NCIH2170_LOW_HER2_R1_G2_24_10_123_Merge(RGB),180,12,168,80,44,22,114,14,180
NCIH2170_TOTAL_HER2_R1_G2_24_10_26_Merge(RGB).tif,NCIH2170_TOTAL_HER2_R1_G2_24_10_26_Merge(RGB),311,6,305,93,23,50,238,20,311
NCIH2170_HIGH_HER2_R1_G2_24_10_7_Merge(RGB).tif,NCIH2170_HIGH_HER2_R1_G2_24_10_7_Merge(RGB),305,23,282,29,6,23,276,0,305
NCIH2170_TOTAL_HER2_R1_G2_24_10_74_Merge(RGB).tif,NCIH2170_TOTAL_HER2_R1_G2_24_10_74_Merge(RGB),159,0,159,51,36,10,113,5,159
NCIH2170_LOW_HER2_R1_G0_2501_12B_Merge.tif (RGB).tif,NCIH2170_LOW_HER2_R1_G0_2501_12B,178,1,177,85,40,32,106,13,178
NCIH2170_TOTAL_HER2_R1_G1_2404_69_Merge(RGB).tif,NCIH2170_TOTAL_HER2_R1_G1_2404_69_Merge(RGB),270,0,270,120,61,52,157,7,270
NCIH2170_HIGH_HER2_R1_G0_2501_118_Merge.tif (RGB).tif,NCIH2170_HIGH_HER2_R1_G0_2501_118,226,17,209,48,15,33,178,0,226
NCIH2170_HIGH_HER2_R1_G0_2501_58_Merge.tif (RGB).tif,NCIH2170_HIGH_HER2_R1_G0_2501_58,200,3,197,76,26,35,139,15,200
NCIH2170_HIGH_HER2_R1_G1_2404_S2_60_Merge(RGB).tif,NCIH2170_HIGH_HER2_R1_G1_2404_S2_60_Merge(RGB),215,0,215,53,25,20,170,8,215
NCIH2170_HIGH_HER2_R1_G2_24_10_34_Merge(RGB).tif,NCIH2170_HIGH_HER2_R1_G2_24_10_34_Merge(RGB),301,25,276,36,9,22,270,5,301
NCIH2170_LOW_HER2_R1_G0_2501_1_Merge.tif (RGB).tif,NCIH2170_LOW_HER2_R1_G0_2501_1,157,4,153,33,0,20,137,13,157
NCIH2170_LOW_HER2_R1_G2_24_10_98_Merge(RGB).tif,NCIH2170_LOW_HER2_R1_G2_24_10_98_Merge(RGB),267,0,267,138,80,30,157,28,267
NCIH2170_HIGH_HER2_R1_G1_2404_S2_14_Merge(RGB).tif,NCIH2170_HIGH_HER2_R1_G1_2404_S2_14_Merge(RGB),384,13,371,188,91,65,228,32,384
NCIH2170_LOW_HER2_R1_G2_24_10_113_Merge(RGB).tif,NCIH2170_LOW_HER2_R1_G2_24_10_113_Merge(RGB),430,13,417,126,53,66,311,7,430
NCIH2170_TOTAL_HER2_R1_G1_2404_118_Merge(RGB).tif,NCIH2170_TOTAL_HER2_R1_G1_2404_118_Merge(RGB),215,0,215,134,84,29,102,21,215
NCIH2170_TOTAL_HER2_R1_G2_24_10_11_Merge(RGB).tif,NCIH2170_TOTAL_HER2_R1_G2_24_10_11_Merge(RGB),253,5,248,97,41,43,169,13,253
NCIH2170_HIGH_HER2_R1_G1_2404_S2_49_Merge(RGB).tif,NCIH2170_HIGH_HER2_R1_G1_2404_S2_49_Merge(RGB),219,0,219,187,132,22,65,33,219
NCIH2170_HIGH_HER2_R1_G0_2501_92_Merge.tif (RGB).tif,NCIH2170_HIGH_HER2_R1_G0_2501_92,148,12,136,41,10,19,119,12,148
NCIH2170_TOTAL_HER2_R1_G2_24_10_92_Merge(RGB).tif,NCIH2170_TOTAL_HER2_R1_G2_24_10_92_Merge(RGB),462,1,461,243,122,89,251,32,462
NCIH2170_LOW_HER2_R1_G1_2404_14_Merge(RGB).tif,NCIH2170_LOW_HER2_R1_G1_2404_14_Merge(RGB),197,32,165,8,0,6,191,2,197
NCIH2170_TOTAL_HER2_R1_G2_24_10_31_Merge(RGB).tif,NCIH2170_TOTAL_HER2_R1_G2_24_10_31_Merge(RGB),556,13,543,231,73,102,381,56,556
NCIH2170_TOTAL_HER2_R1_G0_2501_75_Merge.tif (RGB).tif,NCIH2170_TOTAL_HER2_R1_G0_2501_75,158,0,158,69,22,37,99,10,158
NCIH2170_TOTAL_HER2_R1_G2_24_10_32_Merge(RGB).tif,NCIH2170_TOTAL_HER2_R1_G2_24_10_32_Merge(RGB),590,5,585,400,212,107,271,81,590
NCIH2170_LOW_HER2_R1_G1_2404_16_Merge(RGB).tif,NCIH2170_LOW_HER2_R1_G1_2404_16_Merge(RGB),37,0,37,50,12,8,17,30,37
NCIH2170_HIGH_HER2_R1_G0_2501_97_Merge.tif (RGB).tif,NCIH2170_HIGH_HER2_R1_G0_2501_97,362,11,351,103,38,55,269,10,362
NCIH2170_HIGH_HER2_R1_G1_2404_S2_94_Merge(RGB).tif,NCIH2170_HIGH_HER2_R1_G1_2404_S2_94_Merge(RGB),92,0,92,48,32,13,47,3,92
NCIH2170_LOW_HER2_R1_G0_2501_96_Merge.tif (RGB).tif,NCIH2170_LOW_HER2_R1_G0_2501_96,132,15,117,49,19,20,93,10,132
NCIH2170_HIGH_HER2_R1_G2_24_10_33_Merge(RGB).tif,NCIH2170_HIGH_HER2_R1_G2_24_10_33_Merge(RGB),65,5,60,23,11,8,46,4,65
NCIH2170_TOTAL_HER2_R1_G1_2404_112_Merge(RGB).tif,NCIH2170_TOTAL_HER2_R1_G1_2404_112_Merge(RGB),94,1,93,81,46,17,31,18,94
NCIH2170_LOW_HER2_R1_G0_2501_73_Merge.tif (RGB).tif,NCIH2170_LOW_HER2_R1_G0_2501_73,134,4,130,45,21,18,95,6,134
NCIH2170_TOTAL_HER2_R1_G0_2501_90_Merge.tif (RGB).tif,NCIH2170_TOTAL_HER2_R1_G0_2501_90,113,1,112,40,12,23,78,5,113
NCIH2170_LOW_HER2_R1_G2_24_10_21_Merge(RGB).tif,NCIH2170_LOW_HER2_R1_G2_24_10_21_Merge(RGB),200,0,200,96,48,36,116,12,200
NCIH2170_LOW_HER2_R1_G0_2501_95_Merge.tif (RGB).tif,NCIH2170_LOW_HER2_R1_G0_2501_95,112,13,99,31,14,14,84,3,112
NCIH2170_LOW_HER2_R1_G0_2501_123_Merge.tif (RGB).tif,NCIH2170_LOW_HER2_R1_G0_2501_123,150,8,142,56,20,30,100,6,150
NCIH2170_LOW_HER2_R1_G1_2404_74_Merge(RGB).tif,NCIH2170_LOW_HER2_R1_G1_2404_74_Merge(RGB),67,11,56,34,22,7,38,5,67
NCIH2170_HIGH_HER2_R1_G0_2501_102_Merge.tif (RGB).tif,NCIH2170_HIGH_HER2_R1_G0_2501_102,368,35,333,145,39,100,229,6,368
NCIH2170_TOTAL_HER2_R1_G0_2501_96_Merge.tif (RGB).tif,NCIH2170_TOTAL_HER2_R1_G0_2501_96,279,18,261,109,38,63,178,8,279
NCIH2170_HIGH_HER2_R1_G2_24_10_31_Merge(RGB).tif,NCIH2170_HIGH_HER2_R1_G2_24_10_31_Merge(RGB),230,9,221,83,46,30,154,7,230
NCIH2170_TOTAL_HER2_R1_G1_2404_57_Merge(RGB).tif,NCIH2170_TOTAL_HER2_R1_G1_2404_57_Merge(RGB),327,3,324,130,60,39,228,31,327
NCIH2170_TOTAL_HER2_R1_G0_2501_115_Merge.tif (RGB).tif,NCIH2170_TOTAL_HER2_R1_G0_2501_115,464,0,464,108,30,76,358,2,464
NCIH2170_LOW_HER2_R1_G2_24_10_60_Merge(RGB).tif,NCIH2170_LOW_HER2_R1_G2_24_10_60_Merge(RGB),245,5,240,80,33,31,181,16,245
NCIH2170_TOTAL_HER2_R1_G2_24_10_2_Merge(RGB).tif,NCIH2170_TOTAL_HER2_R1_G2_24_10_2_Merge(RGB),258,25,233,100,29,47,182,24,258
NCIH2170_TOTAL_HER2_R1_G0_2501_78_Merge.tif (RGB).tif,NCIH2170_TOTAL_HER2_R1_G0_2501_78,168,0,168,89,32,24,112,33,168
NCIH2170_LOW_HER2_R1_G1_2404_39_Merge(RGB).tif,NCIH2170_LOW_HER2_R1_G1_2404_39_Merge(RGB),223,10,213,220,123,39,61,58,223
NCIH2170_HIGH_HER2_R1_G2_24_10_78_Merge(RGB).tif,NCIH2170_HIGH_HER2_R1_G2_24_10_78_Merge(RGB),168,18,150,67,26,29,113,12,168
NCIH2170_TOTAL_HER2_R1_G0_2501_109B_Merge.tif (RGB).tif,NCIH2170_TOTAL_HER2_R1_G0_2501_109B,115,6,109,42,22,17,76,3,115
NCIH2170_LOW_HER2_R1_G0_2501_102_Merge.tif (RGB).tif,NCIH2170_LOW_HER2_R1_G0_2501_102,87,18,69,35,8,18,61,9,87
NCIH2170_TOTAL_HER2_R1_G1_2404_78_Merge(RGB).tif,NCIH2170_TOTAL_HER2_R1_G1_2404_78_Merge(RGB),157,0,157,157,41,52,64,64,157
NCIH2170_LOW_HER2_R1_G2_24_10_25_Merge(RGB).tif,NCIH2170_LOW_HER2_R1_G2_24_10_25_Merge(RGB),190,5,185,49,33,12,145,4,190
NCIH2170_TOTAL_HER2_R1_G0_2501_80_Merge.tif (RGB).tif,NCIH2170_TOTAL_HER2_R1_G0_2501_80,282,0,282,70,32,36,214,2,282
NCIH2170_TOTAL_HER2_R1_G2_24_10_82_Merge(RGB).tif,NCIH2170_TOTAL_HER2_R1_G2_24_10_82_Merge(RGB),664,0,664,85,31,42,591,12,664
NCIH2170_TOTAL_HER2_R1_G0_2501_28_Merge.tif (RGB).tif,NCIH2170_TOTAL_HER2_R1_G0_2501_28,190,0,190,42,17,21,152,4,190
NCIH2170_HIGH_HER2_R1_G1_2404_S2_29_Merge(RGB).tif,NCIH2170_HIGH_HER2_R1_G1_2404_S2_29_Merge(RGB),156,3,153,110,57,26,73,27,156
NCIH2170_HIGH_HER2_R1_G1_2404_S2_118_Merge(RGB).tif,NCIH2170_HIGH_HER2_R1_G1_2404_S2_118_Merge(RGB),217,10,207,194,59,68,90,67,217
NCIH2170_HIGH_HER2_R1_G1_2404_S2_43_Merge(RGB).tif,NCIH2170_HIGH_HER2_R1_G1_2404_S2_43_Merge(RGB),71,15,56,27,11,10,50,6,71
NCIH2170_LOW_HER2_R1_G0_2501_54_Merge.tif (RGB).tif,NCIH2170_LOW_HER2_R1_G0_2501_54,188,0,188,69,25,40,123,4,188
NCIH2170_HIGH_HER2_R1_G2_24_10_77_Merge(RGB).tif,NCIH2170_HIGH_HER2_R1_G2_24_10_77_Merge(RGB),150,22,128,34,8,20,122,6,150
NCIH2170_HIGH_HER2_R1_G2_24_10_102_Merge(RGB).tif,NCIH2170_HIGH_HER2_R1_G2_24_10_102_Merge(RGB),122,12,110,31,19,10,93,2,122
NCIH2170_TOTAL_HER2_R1_G2_24_10_120_Merge(RGB).tif,NCIH2170_TOTAL_HER2_R1_G2_24_10_120_Merge(RGB),308,7,301,95,28,50,230,17,308
NCIH2170_HIGH_HER2_R1_G0_2501_100_Merge.tif (RGB).tif,NCIH2170_HIGH_HER2_R1_G0_2501_100,205,14,191,50,26,21,158,3,205
NCIH2170_HIGH_HER2_R1_G2_24_10_117_Merge(RGB).tif,NCIH2170_HIGH_HER2_R1_G2_24_10_117_Merge(RGB),121,0,121,55,18,25,78,12,121
NCIH2170_HIGH_HER2_R1_G0_2501_59_Merge.tif (RGB).tif,NCIH2170_HIGH_HER2_R1_G0_2501_59,186,9,177,52,25,26,135,1,186
NCIH2170_HIGH_HER2_R1_G1_2404_S2_68_Merge(RGB).tif,NCIH2170_HIGH_HER2_R1_G1_2404_S2_68_Merge(RGB),302,37,265,88,52,30,220,6,302
NCIH2170_HIGH_HER2_R1_G0_2501_32_Merge.tif (RGB).tif,NCIH2170_HIGH_HER2_R1_G0_2501_32,243,13,230,61,21,35,187,5,243
NCIH2170_LOW_HER2_R1_G0_2501_36_Merge.tif (RGB).tif,NCIH2170_LOW_HER2_R1_G0_2501_36,206,28,178,43,19,19,168,5,206
NCIH2170_HIGH_HER2_R1_G1_2404_S2_71_Merge(RGB).tif,NCIH2170_HIGH_HER2_R1_G1_2404_S2_71_Merge(RGB),266,0,266,47,13,29,224,5,266
NCIH2170_LOW_HER2_R1_G2_24_10_55_Merge(RGB).tif,NCIH2170_LOW_HER2_R1_G2_24_10_55_Merge(RGB),234,6,228,54,30,18,186,6,234
NCIH2170_LOW_HER2_R1_G1_2404_51_Merge(RGB).tif,NCIH2170_LOW_HER2_R1_G1_2404_51_Merge(RGB),161,2,159,129,63,32,66,34,161
NCIH2170_LOW_HER2_R1_G1_2404_54_Merge(RGB).tif,NCIH2170_LOW_HER2_R1_G1_2404_54_Merge(RGB),215,21,194,140,91,30,94,19,215
NCIH2170_TOTAL_HER2_R1_G2_24_10_126_Merge(RGB).tif,NCIH2170_TOTAL_HER2_R1_G2_24_10_126_Merge(RGB),95,0,95,65,27,20,48,18,95
NCIH2170_HIGH_HER2_R1_G1_2404_S2_9_Merge(RGB).tif,NCIH2170_HIGH_HER2_R1_G1_2404_S2_9_Merge(RGB),276,0,276,177,103,52,121,22,276
NCIH2170_LOW_HER2_R1_G0_2501_52_Merge.tif (RGB).tif,NCIH2170_LOW_HER2_R1_G0_2501_52,137,0,137,28,14,13,110,1,137
NCIH2170_TOTAL_HER2_R1_G0_2501_123_Merge.tif (RGB).tif,NCIH2170_TOTAL_HER2_R1_G0_2501_123,96,0,96,53,29,16,51,8,96
NCIH2170_LOW_HER2_R1_G1_2404_63_Merge(RGB).tif,NCIH2170_LOW_HER2_R1_G1_2404_63_Merge(RGB),123,1,122,93,36,14,73,43,123
NCIH2170_TOTAL_HER2_R1_G0_2501_27B_Merge.tif (RGB).tif,NCIH2170_TOTAL_HER2_R1_G0_2501_27B,187,3,184,94,51,29,107,14,187
NCIH2170_LOW_HER2_R1_G0_2501_56_Merge.tif (RGB).tif,NCIH2170_LOW_HER2_R1_G0_2501_56,118,6,112,17,6,11,101,0,118
NCIH2170_TOTAL_HER2_R1_G2_24_10_127_Merge(RGB).tif,NCIH2170_TOTAL_HER2_R1_G2_24_10_127_Merge(RGB),274,0,274,69,22,36,216,11,274
NCIH2170_TOTAL_HER2_R1_G2_24_10_46_Merge(RGB).tif,NCIH2170_TOTAL_HER2_R1_G2_24_10_46_Merge(RGB),225,3,222,80,44,29,152,7,225
NCIH2170_TOTAL_HER2_R1_G2_24_10_96_Merge(RGB).tif,NCIH2170_TOTAL_HER2_R1_G2_24_10_96_Merge(RGB),510,2,508,158,86,64,360,8,510
NCIH2170_LOW_HER2_R1_G0_2501_31A_Merge.tif (RGB).tif,NCIH2170_LOW_HER2_R1_G0_2501_31A,230,2,228,51,17,30,183,4,230
NCIH2170_TOTAL_HER2_R1_G0_2501_60_Merge.tif (RGB).tif,NCIH2170_TOTAL_HER2_R1_G0_2501_60,127,0,127,69,19,41,67,9,127
NCIH2170_TOTAL_HER2_R1_G2_24_10_114_Merge(RGB).tif,NCIH2170_TOTAL_HER2_R1_G2_24_10_114_Merge(RGB),243,0,243,134,48,43,152,43,243
NCIH2170_HIGH_HER2_R1_G1_2404_S2_38_Merge(RGB).tif,NCIH2170_HIGH_HER2_R1_G1_2404_S2_38_Merge(RGB),156,3,153,100,23,38,95,39,156
NCIH2170_LOW_HER2_R1_G2_24_10_50_Merge(RGB).tif,NCIH2170_LOW_HER2_R1_G2_24_10_50_Merge(RGB),546,7,539,145,63,62,421,20,546
NCIH2170_HIGH_HER2_R1_G0_2501_33_Merge.tif (RGB).tif,NCIH2170_HIGH_HER2_R1_G0_2501_33,152,21,131,49,18,26,108,5,152
NCIH2170_LOW_HER2_R1_G0_2501_80_Merge.tif (RGB).tif,NCIH2170_LOW_HER2_R1_G0_2501_80,103,1,102,23,11,12,80,0,103
NCIH2170_LOW_HER2_R1_G1_2404_68_Merge(RGB).tif,NCIH2170_LOW_HER2_R1_G1_2404_68_Merge(RGB),111,19,92,32,25,5,81,2,111
NCIH2170_HIGH_HER2_R1_G2_24_10_37_Merge(RGB).tif,NCIH2170_HIGH_HER2_R1_G2_24_10_37_Merge(RGB),406,1,405,134,68,57,281,9,406
NCIH2170_HIGH_HER2_R1_G0_2501_19_Merge.tif (RGB).tif,NCIH2170_HIGH_HER2_R1_G0_2501_19,193,13,180,54,23,24,146,7,193
NCIH2170_LOW_HER2_R1_G1_2404_70_Merge(RGB).tif,NCIH2170_LOW_HER2_R1_G1_2404_70_Merge(RGB),221,0,221,142,86,40,95,16,221
NCIH2170_TOTAL_HER2_R1_G0_2501_67_Merge.tif (RGB).tif,NCIH2170_TOTAL_HER2_R1_G0_2501_67,156,11,145,51,24,21,111,6,156
NCIH2170_TOTAL_HER2_R1_G0_2501_107B_Merge.tif (RGB).tif,NCIH2170_TOTAL_HER2_R1_G0_2501_107B,125,0,125,38,9,27,89,2,125
NCIH2170_HIGH_HER2_R1_G2_24_10_24_Merge(RGB).tif,NCIH2170_HIGH_HER2_R1_G2_24_10_24_Merge(RGB),321,2,319,146,63,57,201,26,321
NCIH2170_TOTAL_HER2_R1_G2_24_10_109_Merge(RGB).tif,NCIH2170_TOTAL_HER2_R1_G2_24_10_109_Merge(RGB),188,0,188,45,26,15,147,4,188
NCIH2170_HIGH_HER2_R1_G0_2501_44_Merge.tif (RGB).tif,NCIH2170_HIGH_HER2_R1_G0_2501_44,124,5,119,45,23,16,85,6,124
NCIH2170_LOW_HER2_R1_G2_24_10_47_Merge(RGB).tif,NCIH2170_LOW_HER2_R1_G2_24_10_47_Merge(RGB),160,4,156,47,23,20,117,4,160
NCIH2170_HIGH_HER2_R1_G2_24_10_30_Merge(RGB).tif,NCIH2170_HIGH_HER2_R1_G2_24_10_30_Merge(RGB),333,7,326,105,31,56,246,18,333
NCIH2170_HIGH_HER2_R1_G2_24_10_53_Merge(RGB).tif,NCIH2170_HIGH_HER2_R1_G2_24_10_53_Merge(RGB),369,1,368,96,45,38,286,13,369
NCIH2170_TOTAL_HER2_R1_G2_24_10_15_Merge(RGB).tif,NCIH2170_TOTAL_HER2_R1_G2_24_10_15_Merge(RGB),135,2,133,75,33,30,72,12,135
NCIH2170_HIGH_HER2_R1_G2_24_10_36A_Merge(RGB).tif,NCIH2170_HIGH_HER2_R1_G2_24_10_36A_Merge(RGB),338,2,336,81,43,33,262,5,338
NCIH2170_LOW_HER2_R1_G0_2501_83_Merge.tif (RGB).tif,NCIH2170_LOW_HER2_R1_G0_2501_83,228,1,227,38,8,30,190,0,228
NCIH2170_LOW_HER2_R1_G0_2501_82_Merge.tif (RGB).tif,NCIH2170_LOW_HER2_R1_G0_2501_82,121,0,121,38,21,13,87,4,121
NCIH2170_TOTAL_HER2_R1_G1_2404_100_Merge(RGB).tif,NCIH2170_TOTAL_HER2_R1_G1_2404_100_Merge(RGB),384,16,368,283,177,71,136,35,384
NCIH2170_TOTAL_HER2_R1_G1_2404_41_Merge(RGB).tif,NCIH2170_TOTAL_HER2_R1_G1_2404_41_Merge(RGB),130,0,130,69,38,19,73,12,130
NCIH2170_HIGH_HER2_R1_G2_24_10_48_Merge(RGB).tif,NCIH2170_HIGH_HER2_R1_G2_24_10_48_Merge(RGB),296,19,277,113,21,64,211,28,296
NCIH2170_TOTAL_HER2_R1_G2_24_10_104_Merge(RGB).tif,NCIH2170_TOTAL_HER2_R1_G2_24_10_104_Merge(RGB),290,0,290,83,62,13,215,8,290
NCIH2170_TOTAL_HER2_R1_G0_2501_110_Merge.tif (RGB).tif,NCIH2170_TOTAL_HER2_R1_G0_2501_110,205,3,202,58,30,22,153,6,205
NCIH2170_LOW_HER2_R1_G0_2501_49_Merge.tif (RGB).tif,NCIH2170_LOW_HER2_R1_G0_2501_49,146,10,136,38,21,12,113,5,146
NCIH2170_HIGH_HER2_R1_G1_2404_S2_120_Merge(RGB).tif,NCIH2170_HIGH_HER2_R1_G1_2404_S2_120_Merge(RGB),368,29,339,166,71,65,232,30,368
NCIH2170_TOTAL_HER2_R1_G2_24_10_36_Merge(RGB).tif,NCIH2170_TOTAL_HER2_R1_G2_24_10_36_Merge(RGB),227,11,216,102,21,48,158,33,227
NCIH2170_TOTAL_HER2_R1_G2_24_10_61_Merge(RGB).tif,NCIH2170_TOTAL_HER2_R1_G2_24_10_61_Merge(RGB),518,0,518,190,86,79,353,25,518
NCIH2170_LOW_HER2_R1_G2_24_10_104_Merge(RGB).tif,NCIH2170_LOW_HER2_R1_G2_24_10_104_Merge(RGB),198,4,194,63,31,25,142,7,198
NCIH2170_HIGH_HER2_R1_G0_2501_62_Merge.tif (RGB).tif,NCIH2170_HIGH_HER2_R1_G0_2501_62,146,2,144,33,17,13,116,3,146
NCIH2170_LOW_HER2_R1_G0_2501_90_Merge.tif (RGB).tif,NCIH2170_LOW_HER2_R1_G0_2501_90,66,2,64,38,18,15,33,5,66
NCIH2170_LOW_HER2_R1_G2_24_10_7_Merge(RGB).tif,NCIH2170_LOW_HER2_R1_G2_24_10_7_Merge(RGB),133,7,126,44,19,21,93,4,133
NCIH2170_TOTAL_HER2_R1_G2_24_10_123_Merge(RGB).tif,NCIH2170_TOTAL_HER2_R1_G2_24_10_123_Merge(RGB),309,0,309,124,56,47,206,21,309
NCIH2170_HIGH_HER2_R1_G0_2501_120_Merge.tif (RGB).tif,NCIH2170_HIGH_HER2_R1_G0_2501_120,112,28,84,26,14,9,89,3,112
NCIH2170_LOW_HER2_R1_G1_2404_79_Merge(RGB).tif,NCIH2170_LOW_HER2_R1_G1_2404_79_Merge(RGB),180,2,178,69,36,20,124,13,180
NCIH2170_LOW_HER2_R1_G2_24_10_66_Merge(RGB).tif,NCIH2170_LOW_HER2_R1_G2_24_10_66_Merge(RGB),139,2,137,109,62,25,52,22,139
NCIH2170_LOW_HER2_R1_G0_2501_24_Merge.tif (RGB).tif,NCIH2170_LOW_HER2_R1_G0_2501_24,111,0,111,22,8,11,92,3,111
NCIH2170_TOTAL_HER2_R1_G2_24_10_75_Merge(RGB).tif,NCIH2170_TOTAL_HER2_R1_G2_24_10_75_Merge(RGB),160,0,160,47,29,16,115,2,160
NCIH2170_LOW_HER2_R1_G1_2404_47_Merge(RGB).tif,NCIH2170_LOW_HER2_R1_G1_2404_47_Merge(RGB),242,6,236,98,48,41,153,9,242
NCIH2170_LOW_HER2_R1_G2_24_10_124_Merge(RGB).tif,NCIH2170_LOW_HER2_R1_G2_24_10_124_Merge(RGB),172,10,162,91,49,29,94,13,172
NCIH2170_HIGH_HER2_R1_G2_24_10_130_Merge(RGB).tif,NCIH2170_HIGH_HER2_R1_G2_24_10_130_Merge(RGB),155,4,151,99,36,32,87,31,155
NCIH2170_LOW_HER2_R1_G2_24_10_82_Merge(RGB).tif,NCIH2170_LOW_HER2_R1_G2_24_10_82_Merge(RGB),63,2,61,26,17,7,39,2,63
NCIH2170_LOW_HER2_R1_G0_2501_51_Merge.tif (RGB).tif,NCIH2170_LOW_HER2_R1_G0_2501_51,197,14,183,50,16,32,149,2,197
NCIH2170_LOW_HER2_R1_G0_2501_57_Merge.tif (RGB).tif,NCIH2170_LOW_HER2_R1_G0_2501_57,123,13,110,30,10,17,96,3,123
NCIH2170_LOW_HER2_R1_G0_2501_118_Merge.tif (RGB).tif,NCIH2170_LOW_HER2_R1_G0_2501_118,51,1,50,25,10,8,33,7,51
NCIH2170_TOTAL_HER2_R1_G2_24_10_81_Merge(RGB).tif,NCIH2170_TOTAL_HER2_R1_G2_24_10_81_Merge(RGB),130,1,129,60,36,20,74,4,130
NCIH2170_LOW_HER2_R1_G0_2501_69_Merge.tif (RGB).tif,NCIH2170_LOW_HER2_R1_G0_2501_69,135,22,113,13,4,9,122,0,135
NCIH2170_TOTAL_HER2_R1_G1_2404_15_Merge(RGB).tif,NCIH2170_TOTAL_HER2_R1_G1_2404_15_Merge(RGB),363,33,330,181,107,61,195,13,363
NCIH2170_LOW_HER2_R1_G0_2501_71_Merge.tif (RGB).tif,NCIH2170_LOW_HER2_R1_G0_2501_71,221,9,212,32,15,14,192,3,221
NCIH2170_TOTAL_HER2_R1_G1_2404_127_Merge(RGB).tif,NCIH2170_TOTAL_HER2_R1_G1_2404_127_Merge(RGB),51,3,48,67,12,15,24,40,51
NCIH2170_LOW_HER2_R1_G0_2501_92_Merge.tif (RGB).tif,NCIH2170_LOW_HER2_R1_G0_2501_92,54,1,53,12,4,8,42,0,54
NCIH2170_LOW_HER2_R1_G1_2404_36_Merge(RGB).tif,NCIH2170_LOW_HER2_R1_G1_2404_36_Merge(RGB),98,14,84,62,34,15,49,13,98
NCIH2170_LOW_HER2_R1_G2_24_10_75_Merge(RGB).tif,NCIH2170_LOW_HER2_R1_G2_24_10_75_Merge(RGB),193,31,162,79,51,17,125,11,193
NCIH2170_LOW_HER2_R1_G0_2501_130_Merge.tif (RGB).tif,NCIH2170_LOW_HER2_R1_G0_2501_130,133,2,131,39,15,21,97,3,133
NCIH2170_TOTAL_HER2_R1_G2_24_10_95_Merge(RGB).tif,NCIH2170_TOTAL_HER2_R1_G2_24_10_95_Merge(RGB),291,0,291,82,42,25,224,15,291
NCIH2170_HIGH_HER2_R1_G2_24_10_104_Merge(RGB).tif,NCIH2170_HIGH_HER2_R1_G2_24_10_104_Merge(RGB),193,13,180,56,29,21,143,6,193
NCIH2170_LOW_HER2_R1_G1_2404_84_Merge(RGB).tif,NCIH2170_LOW_HER2_R1_G1_2404_84_Merge(RGB),332,7,325,184,92,60,180,32,332
NCIH2170_LOW_HER2_R1_G1_2404_4_Merge(RGB).tif,NCIH2170_LOW_HER2_R1_G1_2404_4_Merge(RGB),82,1,81,67,23,22,37,22,82
NCIH2170_LOW_HER2_R1_G1_2404_5_Merge(RGB).tif,NCIH2170_LOW_HER2_R1_G1_2404_5_Merge(RGB),79,3,76,45,23,8,48,14,79
NCIH2170_HIGH_HER2_R1_G1_2404_S2_48_Merge(RGB).tif,NCIH2170_HIGH_HER2_R1_G1_2404_S2_48_Merge(RGB),261,0,261,142,73,37,151,32,261
NCIH2170_TOTAL_HER2_R1_G0_2501_81_Merge.tif (RGB).tif,NCIH2170_TOTAL_HER2_R1_G0_2501_81,139,0,139,49,18,26,95,5,139
NCIH2170_LOW_HER2_R1_G0_2501_105_Merge.tif (RGB).tif,NCIH2170_LOW_HER2_R1_G0_2501_105,221,21,200,39,12,25,184,2,221
NCIH2170_HIGH_HER2_R1_G0_2501_42_Merge.tif (RGB).tif,NCIH2170_HIGH_HER2_R1_G0_2501_42,215,4,211,101,45,34,136,22,215
NCIH2170_HIGH_HER2_R1_G0_2501_57_Merge.tif (RGB).tif,NCIH2170_HIGH_HER2_R1_G0_2501_57,179,3,176,50,22,24,133,4,179
NCIH2170_HIGH_HER2_R1_G0_2501_2_Merge.tif (RGB).tif,NCIH2170_HIGH_HER2_R1_G0_2501_2,212,2,210,27,3,16,193,8,212
NCIH2170_TOTAL_HER2_R1_G1_2404_82_Merge(RGB).tif,NCIH2170_TOTAL_HER2_R1_G1_2404_82_Merge(RGB),152,0,152,114,72,18,62,24,152
NCIH2170_HIGH_HER2_R1_G0_2501_26_Merge.tif (RGB).tif,NCIH2170_HIGH_HER2_R1_G0_2501_26,222,6,216,50,18,28,176,4,222
NCIH2170_TOTAL_HER2_R1_G1_2404_33_Merge(RGB).tif,NCIH2170_TOTAL_HER2_R1_G1_2404_33_Merge(RGB),58,0,58,20,15,3,40,2,58
NCIH2170_TOTAL_HER2_R1_G1_2404_124_Merge(RGB).tif,NCIH2170_TOTAL_HER2_R1_G1_2404_124_Merge(RGB),328,3,325,174,103,32,193,39,328
NCIH2170_LOW_HER2_R1_G0_2501_58_Merge.tif (RGB).tif,NCIH2170_LOW_HER2_R1_G0_2501_58,184,1,183,73,18,36,130,19,184
NCIH2170_TOTAL_HER2_R1_G0_2501_34_Merge.tif (RGB).tif,NCIH2170_TOTAL_HER2_R1_G0_2501_34,211,22,189,51,15,30,166,6,211
NCIH2170_HIGH_HER2_R1_G2_24_10_58_Merge(RGB).tif,NCIH2170_HIGH_HER2_R1_G2_24_10_58_Merge(RGB),66,9,57,35,22,6,38,7,66
NCIH2170_TOTAL_HER2_R1_G2_24_10_70_Merge(RGB).tif,NCIH2170_TOTAL_HER2_R1_G2_24_10_70_Merge(RGB),247,2,245,130,64,45,138,21,247
NCIH2170_TOTAL_HER2_R1_G1_2404_36_Merge(RGB).tif,NCIH2170_TOTAL_HER2_R1_G1_2404_36_Merge(RGB),164,5,159,99,36,26,102,37,164
NCIH2170_TOTAL_HER2_R1_G2_24_10_33_Merge(RGB).tif,NCIH2170_TOTAL_HER2_R1_G2_24_10_33_Merge(RGB),105,20,85,44,13,19,73,12,105
NCIH2170_HIGH_HER2_R1_G0_2501_73_Merge.tif (RGB).tif,NCIH2170_HIGH_HER2_R1_G0_2501_73,118,19,99,59,22,15,81,22,118
NCIH2170_HIGH_HER2_R1_G1_2404_S2_83_Merge(RGB).tif,NCIH2170_HIGH_HER2_R1_G1_2404_S2_83_Merge(RGB),437,5,432,246,156,63,218,27,437
NCIH2170_HIGH_HER2_R1_G1_2404_S2_86_Merge(RGB).tif,NCIH2170_HIGH_HER2_R1_G1_2404_S2_86_Merge(RGB),164,0,164,87,49,22,93,16,164
NCIH2170_TOTAL_HER2_R1_G1_2404_77_Merge(RGB).tif,NCIH2170_TOTAL_HER2_R1_G1_2404_77_Merge(RGB),137,5,132,65,5,26,106,34,137
NCIH2170_TOTAL_HER2_R1_G1_2404_55_Merge(RGB).tif,NCIH2170_TOTAL_HER2_R1_G1_2404_55_Merge(RGB),142,9,133,82,32,23,87,27,142
NCIH2170_HIGH_HER2_R1_G0_2501_106_Merge.tif (RGB).tif,NCIH2170_HIGH_HER2_R1_G0_2501_106,200,11,189,34,9,25,166,0,200
NCIH2170_TOTAL_HER2_R1_G1_2404_29_Merge(RGB).tif,NCIH2170_TOTAL_HER2_R1_G1_2404_29_Merge(RGB),112,0,112,44,26,9,77,9,112
NCIH2170_TOTAL_HER2_R1_G1_2404_110_Merge(RGB).tif,NCIH2170_TOTAL_HER2_R1_G1_2404_110_Merge(RGB),125,0,125,76,35,15,75,26,125
NCIH2170_HIGH_HER2_R1_G0_2501_5_Merge.tif (RGB).tif,NCIH2170_HIGH_HER2_R1_G0_2501_5,361,8,353,50,2,29,330,19,361
NCIH2170_LOW_HER2_R1_G0_2501_6_Merge.tif (RGB).tif,NCIH2170_LOW_HER2_R1_G0_2501_6,114,3,111,16,0,5,109,11,114
NCIH2170_LOW_HER2_R1_G0_2501_115_Merge.tif (RGB).tif,NCIH2170_LOW_HER2_R1_G0_2501_115,95,3,92,17,7,7,81,3,95
NCIH2170_HIGH_HER2_R1_G0_2501_28_Merge.tif (RGB).tif,NCIH2170_HIGH_HER2_R1_G0_2501_28,437,3,434,47,17,29,391,1,437
NCIH2170_LOW_HER2_R1_G0_2501_108_Merge.tif (RGB).tif,NCIH2170_LOW_HER2_R1_G0_2501_108,108,15,93,44,24,10,74,10,108
NCIH2170_HIGH_HER2_R1_G2_24_10_83_Merge(RGB).tif,NCIH2170_HIGH_HER2_R1_G2_24_10_83_Merge(RGB),250,1,249,100,33,50,167,17,250
NCIH2170_HIGH_HER2_R1_G1_2404_S2_106_Merge(RGB).tif,NCIH2170_HIGH_HER2_R1_G1_2404_S2_106_Merge(RGB),230,0,230,86,35,34,161,17,230
NCIH2170_LOW_HER2_R1_G0_2501_104_Merge.tif (RGB).tif,NCIH2170_LOW_HER2_R1_G0_2501_104,172,3,169,33,7,21,144,5,172
NCIH2170_LOW_HER2_R1_G2_24_10_126_Merge(RGB).tif,NCIH2170_LOW_HER2_R1_G2_24_10_126_Merge(RGB),276,1,275,89,51,25,200,13,276
NCIH2170_LOW_HER2_R1_G0_2501_4_Merge.tif (RGB).tif,NCIH2170_LOW_HER2_R1_G0_2501_4,139,7,132,10,0,7,132,3,139
NCIH2170_TOTAL_HER2_R1_G0_2501_86_Merge.tif (RGB).tif,NCIH2170_TOTAL_HER2_R1_G0_2501_86,300,1,299,45,20,23,257,2,300
NCIH2170_TOTAL_HER2_R1_G1_2404_28_Merge(RGB).tif,NCIH2170_TOTAL_HER2_R1_G1_2404_28_Merge(RGB),82,2,80,50,24,12,46,14,82
NCIH2170_HIGH_HER2_R1_G0_2501_89_Merge.tif (RGB).tif,NCIH2170_HIGH_HER2_R1_G0_2501_89,137,18,119,47,20,14,103,13,137
NCIH2170_HIGH_HER2_R1_G1_2404_S2_16_Merge(RGB).tif,NCIH2170_HIGH_HER2_R1_G1_2404_S2_16_Merge(RGB),720,3,717,335,168,124,428,43,720
NCIH2170_LOW_HER2_R1_G2_24_10_56_Merge(RGB).tif,NCIH2170_LOW_HER2_R1_G2_24_10_56_Merge(RGB),59,14,45,16,8,4,47,4,59
NCIH2170_HIGH_HER2_R1_G0_2501_16_Merge.tif (RGB).tif,NCIH2170_HIGH_HER2_R1_G0_2501_16,148,5,143,26,11,14,123,1,148
NCIH2170_HIGH_HER2_R1_G2_24_10_29_Merge(RGB).tif,NCIH2170_HIGH_HER2_R1_G2_24_10_29_Merge(RGB),372,11,361,144,32,94,246,18,372
NCIH2170_LOW_HER2_R1_G1_2404_12_Merge(RGB).tif,NCIH2170_LOW_HER2_R1_G1_2404_12_Merge(RGB),484,11,473,234,150,55,279,29,484
NCIH2170_TOTAL_HER2_R1_G0_2501_41_Merge.tif (RGB).tif,NCIH2170_TOTAL_HER2_R1_G0_2501_41,163,17,146,23,7,16,140,0,163
NCIH2170_TOTAL_HER2_R1_G2_24_10_34_Merge(RGB).tif,NCIH2170_TOTAL_HER2_R1_G2_24_10_34_Merge(RGB),230,6,224,85,26,33,171,26,230
NCIH2170_LOW_HER2_R1_G2_24_10_127_Merge(RGB).tif,NCIH2170_LOW_HER2_R1_G2_24_10_127_Merge(RGB),156,2,154,89,40,27,89,22,156
NCIH2170_LOW_HER2_R1_G0_2501_81_Merge.tif (RGB).tif,NCIH2170_LOW_HER2_R1_G0_2501_81,74,0,74,14,5,8,61,1,74
NCIH2170_HIGH_HER2_R1_G2_24_10_79_Merge(RGB).tif,NCIH2170_HIGH_HER2_R1_G2_24_10_79_Merge(RGB),97,10,87,46,17,15,65,14,97
NCIH2170_TOTAL_HER2_R1_G0_2501_59_Merge.tif (RGB).tif,NCIH2170_TOTAL_HER2_R1_G0_2501_59,132,5,127,60,27,29,76,4,132
NCIH2170_LOW_HER2_R1_G0_2501_67_Merge.tif (RGB).tif,NCIH2170_LOW_HER2_R1_G0_2501_67,165,19,146,35,11,23,131,1,165
NCIH2170_HIGH_HER2_R1_G1_2404_S2_88_Merge(RGB).tif,NCIH2170_HIGH_HER2_R1_G1_2404_S2_88_Merge(RGB),420,2,418,266,136,95,189,35,420
NCIH2170_LOW_HER2_R1_G0_2501_40_Merge.tif (RGB).tif,NCIH2170_LOW_HER2_R1_G0_2501_40,86,5,81,42,11,24,51,7,86
NCIH2170_LOW_HER2_R1_G2_24_10_54_Merge(RGB).tif,NCIH2170_LOW_HER2_R1_G2_24_10_54_Merge(RGB),100,1,99,62,42,10,48,10,100
NCIH2170_HIGH_HER2_R1_G0_2501_75_Merge.tif (RGB).tif,NCIH2170_HIGH_HER2_R1_G0_2501_75,148,4,144,48,21,19,108,8,148
NCIH2170_TOTAL_HER2_R1_G2_24_10_72_Merge(RGB).tif,NCIH2170_TOTAL_HER2_R1_G2_24_10_72_Merge(RGB),219,2,217,93,43,30,146,20,219
NCIH2170_TOTAL_HER2_R1_G1_2404_61_Merge(RGB).tif,NCIH2170_TOTAL_HER2_R1_G1_2404_61_Merge(RGB),185,9,176,122,49,49,87,24,185
NCIH2170_LOW_HER2_R1_G2_24_10_99A_Merge(RGB).tif,NCIH2170_LOW_HER2_R1_G2_24_10_99A_Merge(RGB),166,8,158,46,30,12,124,4,166
NCIH2170_LOW_HER2_R1_G0_2501_125_Merge.tif (RGB).tif,NCIH2170_LOW_HER2_R1_G0_2501_125,154,6,148,47,16,20,118,11,154
NCIH2170_HIGH_HER2_R1_G1_2404_S2_27_Merge(RGB).tif,NCIH2170_HIGH_HER2_R1_G1_2404_S2_27_Merge(RGB),212,1,211,40,13,21,178,6,212
NCIH2170_TOTAL_HER2_R1_G2_24_10_58_Merge(RGB).tif,NCIH2170_TOTAL_HER2_R1_G2_24_10_58_Merge(RGB),169,8,161,29,7,18,144,4,169
NCIH2170_LOW_HER2_R1_G2_24_10_57B_Merge(RGB).tif,NCIH2170_LOW_HER2_R1_G2_24_10_57B_Merge(RGB),76,4,72,39,20,10,46,9,76
NCIH2170_TOTAL_HER2_R1_G1_2404_66_Merge(RGB).tif,NCIH2170_TOTAL_HER2_R1_G1_2404_66_Merge(RGB),58,0,58,41,21,3,34,17,58
NCIH2170_HIGH_HER2_R1_G2_24_10_66_Merge(RGB).tif,NCIH2170_HIGH_HER2_R1_G2_24_10_66_Merge(RGB),316,63,253,68,41,21,254,6,316
NCIH2170_LOW_HER2_R1_G0_2501_39_Merge.tif (RGB).tif,NCIH2170_LOW_HER2_R1_G0_2501_39,46,2,44,24,6,9,31,9,46
NCIH2170_LOW_HER2_R1_G1_2404_6_Merge(RGB).tif,NCIH2170_LOW_HER2_R1_G1_2404_6_Merge(RGB),364,0,364,210,78,92,194,40,364
NCIH2170_LOW_HER2_R1_G0_2501_129_Merge.tif (RGB).tif,NCIH2170_LOW_HER2_R1_G0_2501_129,106,2,104,36,17,13,76,6,106
NCIH2170_LOW_HER2_R1_G1_2404_81_Merge(RGB).tif,NCIH2170_LOW_HER2_R1_G1_2404_81_Merge(RGB),130,1,129,118,39,42,49,37,130
NCIH2170_LOW_HER2_R1_G0_2501_22_Merge.tif (RGB).tif,NCIH2170_LOW_HER2_R1_G0_2501_22,124,3,121,35,21,13,90,1,124
NCIH2170_TOTAL_HER2_R1_G0_2501_56A_Merge.tif (RGB).tif,NCIH2170_TOTAL_HER2_R1_G0_2501_56A,142,36,106,35,19,16,107,0,142
NCIH2170_HIGH_HER2_R1_G2_24_10_56_Merge(RGB).tif,NCIH2170_HIGH_HER2_R1_G2_24_10_56_Merge(RGB),323,5,318,112,62,37,224,13,323
NCIH2170_LOW_HER2_R1_G2_24_10_107_Merge(RGB).tif,NCIH2170_LOW_HER2_R1_G2_24_10_107_Merge(RGB),175,1,174,64,26,27,122,11,175
NCIH2170_TOTAL_HER2_R1_G0_2501_14_Merge.tif (RGB).tif,NCIH2170_TOTAL_HER2_R1_G0_2501_14,156,15,141,28,9,18,129,1,156
NCIH2170_HIGH_HER2_R1_G1_2404_S2_42_Merge(RGB).tif,NCIH2170_HIGH_HER2_R1_G1_2404_S2_42_Merge(RGB),166,1,165,54,25,21,120,8,166
NCIH2170_LOW_HER2_R1_G1_2404_21_Merge(RGB).tif,NCIH2170_LOW_HER2_R1_G1_2404_21_Merge(RGB),55,0,55,51,39,3,13,9,55
NCIH2170_TOTAL_HER2_R1_G1_2404_74_Merge(RGB).tif,NCIH2170_TOTAL_HER2_R1_G1_2404_74_Merge(RGB),66,2,64,57,21,19,26,17,66
NCIH2170_TOTAL_HER2_R1_G0_2501_19_Merge.tif (RGB).tif,NCIH2170_TOTAL_HER2_R1_G0_2501_19,126,1,125,25,7,16,103,2,126
NCIH2170_LOW_HER2_R1_G2_24_10_81_Merge(RGB).tif,NCIH2170_LOW_HER2_R1_G2_24_10_81_Merge(RGB),115,37,78,44,9,21,85,14,115
NCIH2170_TOTAL_HER2_R1_G0_2501_94_Merge.tif (RGB).tif,NCIH2170_TOTAL_HER2_R1_G0_2501_94,190,0,190,57,23,31,136,3,190
NCIH2170_TOTAL_HER2_R1_G1_2404_7_Merge(RGB).tif,NCIH2170_TOTAL_HER2_R1_G1_2404_7_Merge(RGB),142,31,111,44,13,18,111,13,142
NCIH2170_HIGH_HER2_R1_G1_2404_S2_102_Merge(RGB).tif,NCIH2170_HIGH_HER2_R1_G1_2404_S2_102_Merge(RGB),202,0,202,86,50,24,128,12,202
NCIH2170_HIGH_HER2_R1_G0_2501_115_Merge.tif (RGB).tif,NCIH2170_HIGH_HER2_R1_G0_2501_115,387,4,383,186,69,92,226,25,387
NCIH2170_TOTAL_HER2_R1_G0_2501_104_Merge.tif (RGB).tif,NCIH2170_TOTAL_HER2_R1_G0_2501_104,146,0,146,64,22,37,87,5,146
NCIH2170_TOTAL_HER2_R1_G1_2404_119_Merge(RGB).tif,NCIH2170_TOTAL_HER2_R1_G1_2404_119_Merge(RGB),60,6,54,33,15,7,38,11,60
NCIH2170_TOTAL_HER2_R1_G2_24_10_1_Merge(RGB).tif,NCIH2170_TOTAL_HER2_R1_G2_24_10_1_Merge(RGB),82,1,81,92,35,16,31,41,82
NCIH2170_TOTAL_HER2_R1_G2_24_10_116_Merge(RGB).tif,NCIH2170_TOTAL_HER2_R1_G2_24_10_116_Merge(RGB),461,0,461,121,69,39,353,13,461
NCIH2170_HIGH_HER2_R1_G2_24_10_1_Merge(RGB).tif,NCIH2170_HIGH_HER2_R1_G2_24_10_1_Merge(RGB),230,49,181,89,42,42,146,5,230
NCIH2170_LOW_HER2_R1_G1_2404_29_Merge(RGB).tif,NCIH2170_LOW_HER2_R1_G1_2404_29_Merge(RGB),53,0,53,50,15,17,21,18,53
NCIH2170_HIGH_HER2_R1_G0_2501_55_Merge.tif (RGB).tif,NCIH2170_HIGH_HER2_R1_G0_2501_55,263,9,254,64,23,33,207,8,263
NCIH2170_TOTAL_HER2_R1_G1_2404_79_Merge(RGB).tif,NCIH2170_TOTAL_HER2_R1_G1_2404_79_Merge(RGB),264,53,211,106,32,42,190,32,264
NCIH2170_TOTAL_HER2_R1_G2_24_10_63_Merge(RGB).tif,NCIH2170_TOTAL_HER2_R1_G2_24_10_63_Merge(RGB),213,0,213,82,54,18,141,10,213
NCIH2170_HIGH_HER2_R1_G0_2501_27_Merge.tif (RGB).tif,NCIH2170_HIGH_HER2_R1_G0_2501_27,92,4,88,36,21,12,59,3,92
NCIH2170_HIGH_HER2_R1_G1_2404_S2_58_Merge(RGB).tif,NCIH2170_HIGH_HER2_R1_G1_2404_S2_58_Merge(RGB),114,8,106,42,29,11,74,2,114
NCIH2170_TOTAL_HER2_R1_G2_24_10_52_Merge(RGB).tif,NCIH2170_TOTAL_HER2_R1_G2_24_10_52_Merge(RGB),273,0,273,153,46,67,160,40,273
NCIH2170_TOTAL_HER2_R1_G1_2404_34_Merge(RGB).tif,NCIH2170_TOTAL_HER2_R1_G1_2404_34_Merge(RGB),89,4,85,40,13,14,62,13,89
NCIH2170_TOTAL_HER2_R1_G1_2404_54_Merge(RGB).tif,NCIH2170_TOTAL_HER2_R1_G1_2404_54_Merge(RGB),119,14,105,77,38,18,63,21,119
NCIH2170_LOW_HER2_R1_G0_2501_21_Merge.tif (RGB).tif,NCIH2170_LOW_HER2_R1_G0_2501_21,127,16,111,25,11,12,104,2,127
NCIH2170_LOW_HER2_R1_G2_24_10_2_Merge(RGB).tif,NCIH2170_LOW_HER2_R1_G2_24_10_2_Merge(RGB),286,0,286,81,37,34,215,10,286
NCIH2170_LOW_HER2_R1_G2_24_10_32_Merge(RGB).tif,NCIH2170_LOW_HER2_R1_G2_24_10_32_Merge(RGB),355,7,348,139,76,26,253,37,355
NCIH2170_LOW_HER2_R1_G0_2501_42_Merge.tif (RGB).tif,NCIH2170_LOW_HER2_R1_G0_2501_42,129,18,111,55,25,24,80,6,129
NCIH2170_HIGH_HER2_R1_G1_2404_S2_51_Merge(RGB).tif,NCIH2170_HIGH_HER2_R1_G1_2404_S2_51_Merge(RGB),260,0,260,139,97,23,140,19,260
NCIH2170_HIGH_HER2_R1_G0_2501_65_Merge.tif (RGB).tif,NCIH2170_HIGH_HER2_R1_G0_2501_65,156,5,151,35,21,14,121,0,156
NCIH2170_HIGH_HER2_R1_G1_2404_S2_70_Merge(RGB).tif,NCIH2170_HIGH_HER2_R1_G1_2404_S2_70_Merge(RGB),389,8,381,118,52,46,291,20,389
NCIH2170_HIGH_HER2_R1_G0_2501_23_Merge.tif (RGB).tif,NCIH2170_HIGH_HER2_R1_G0_2501_23,343,7,336,102,47,49,247,6,343
NCIH2170_LOW_HER2_R1_G2_24_10_1_Merge(RGB).tif,NCIH2170_LOW_HER2_R1_G2_24_10_1_Merge(RGB),186,3,183,65,29,26,131,10,186
NCIH2170_HIGH_HER2_R1_G0_2501_129_Merge.tif (RGB).tif,NCIH2170_HIGH_HER2_R1_G0_2501_129,143,8,135,51,23,24,96,4,143
NCIH2170_TOTAL_HER2_R1_G2_24_10_12_Merge(RGB).tif,NCIH2170_TOTAL_HER2_R1_G2_24_10_12_Merge(RGB),235,6,229,103,28,56,151,19,235
NCIH2170_HIGH_HER2_R1_G1_2404_S2_66_Merge(RGB).tif,NCIH2170_HIGH_HER2_R1_G1_2404_S2_66_Merge(RGB),137,2,135,87,41,28,68,18,137
NCIH2170_LOW_HER2_R1_G2_24_10_102_Merge(RGB).tif,NCIH2170_LOW_HER2_R1_G2_24_10_102_Merge(RGB),203,8,195,73,31,29,143,13,203
NCIH2170_TOTAL_HER2_R1_G2_24_10_129_Merge(RGB).tif,NCIH2170_TOTAL_HER2_R1_G2_24_10_129_Merge(RGB),258,1,257,83,30,36,192,17,258
NCIH2170_LOW_HER2_R1_G2_24_10_118_Merge(RGB).tif,NCIH2170_LOW_HER2_R1_G2_24_10_118_Merge(RGB),177,10,167,50,20,24,133,6,177
NCIH2170_TOTAL_HER2_R1_G0_2501_1_Merge.tif (RGB).tif,NCIH2170_TOTAL_HER2_R1_G0_2501_1,110,1,109,102,1,36,73,65,110
NCIH2170_TOTAL_HER2_R1_G0_2501_25_Merge.tif (RGB).tif,NCIH2170_TOTAL_HER2_R1_G0_2501_25,88,0,88,23,10,8,70,5,88
NCIH2170_HIGH_HER2_R1_G0_2501_25_Merge.tif (RGB).tif,NCIH2170_HIGH_HER2_R1_G0_2501_25,133,6,127,16,5,11,117,0,133
NCIH2170_TOTAL_HER2_R1_G0_2501_47B_Merge.tif (RGB).tif,NCIH2170_TOTAL_HER2_R1_G0_2501_47B,73,0,73,20,11,8,54,1,73
NCIH2170_HIGH_HER2_R1_G0_2501_49_Merge.tif (RGB).tif,NCIH2170_HIGH_HER2_R1_G0_2501_49,183,17,166,69,25,32,126,12,183
NCIH2170_HIGH_HER2_R1_G2_24_10_36C_Merge(RGB).tif,NCIH2170_HIGH_HER2_R1_G2_24_10_36C_Merge(RGB),268,6,262,117,59,42,167,16,268
NCIH2170_LOW_HER2_R1_G2_24_10_15_Merge(RGB).tif,NCIH2170_LOW_HER2_R1_G2_24_10_15_Merge(RGB),148,0,148,26,8,10,130,8,148
NCIH2170_TOTAL_HER2_R1_G2_24_10_79_Merge(RGB).tif,NCIH2170_TOTAL_HER2_R1_G2_24_10_79_Merge(RGB),250,0,250,67,49,13,188,5,250
NCIH2170_TOTAL_HER2_R1_G2_24_10_125_Merge(RGB).tif,NCIH2170_TOTAL_HER2_R1_G2_24_10_125_Merge(RGB),470,11,459,98,50,39,381,9,470
NCIH2170_HIGH_HER2_R1_G0_2501_1_Merge.tif (RGB).tif,NCIH2170_HIGH_HER2_R1_G0_2501_1,239,2,237,30,0,25,214,5,239
NCIH2170_TOTAL_HER2_R1_G1_2404_123_Merge(RGB).tif,NCIH2170_TOTAL_HER2_R1_G1_2404_123_Merge(RGB),219,8,211,162,114,24,81,24,219
NCIH2170_HIGH_HER2_R1_G0_2501_114_Merge.tif (RGB).tif,NCIH2170_HIGH_HER2_R1_G0_2501_114,167,10,157,53,14,35,118,4,167
NCIH2170_HIGH_HER2_R1_G0_2501_125_Merge.tif (RGB).tif,NCIH2170_HIGH_HER2_R1_G0_2501_125,231,6,225,78,18,48,165,12,231
NCIH2170_HIGH_HER2_R1_G2_24_10_75_Merge(RGB).tif,NCIH2170_HIGH_HER2_R1_G2_24_10_75_Merge(RGB),220,24,196,107,62,27,131,18,220
NCIH2170_HIGH_HER2_R1_G1_2404_S2_33_Merge(RGB).tif,NCIH2170_HIGH_HER2_R1_G1_2404_S2_33_Merge(RGB),74,0,74,3,1,1,72,1,74
NCIH2170_TOTAL_HER2_R1_G1_2404_63_Merge(RGB).tif,NCIH2170_TOTAL_HER2_R1_G1_2404_63_Merge(RGB),192,12,180,126,86,17,89,23,192
NCIH2170_TOTAL_HER2_R1_G0_2501_107A_Merge.tif (RGB).tif,NCIH2170_TOTAL_HER2_R1_G0_2501_107A,128,27,101,57,30,19,79,8,128
NCIH2170_LOW_HER2_R1_G0_2501_74_Merge.tif (RGB).tif,NCIH2170_LOW_HER2_R1_G0_2501_74,103,9,94,25,9,13,81,3,103
NCIH2170_LOW_HER2_R1_G1_2404_73_Merge(RGB).tif,NCIH2170_LOW_HER2_R1_G1_2404_73_Merge(RGB),267,6,261,65,34,22,211,9,267
NCIH2170_TOTAL_HER2_R1_G1_2404_47_Merge(RGB).tif,NCIH2170_TOTAL_HER2_R1_G1_2404_47_Merge(RGB),190,0,190,133,55,41,94,37,190
NCIH2170_LOW_HER2_R1_G0_2501_126_Merge.tif (RGB).tif,NCIH2170_LOW_HER2_R1_G0_2501_126,128,1,127,38,17,19,92,2,128
NCIH2170_TOTAL_HER2_R1_G0_2501_55_Merge.tif (RGB).tif,NCIH2170_TOTAL_HER2_R1_G0_2501_55,143,0,143,22,10,11,122,1,143
NCIH2170_LOW_HER2_R1_G1_2404_19_Merge(RGB).tif,NCIH2170_LOW_HER2_R1_G1_2404_19_Merge(RGB),52,0,52,23,17,3,32,3,52
NCIH2170_TOTAL_HER2_R1_G2_24_10_86_Merge(RGB).tif,NCIH2170_TOTAL_HER2_R1_G2_24_10_86_Merge(RGB),159,0,159,86,58,22,79,6,159
NCIH2170_HIGH_HER2_R1_G0_2501_37_Merge.tif (RGB).tif,NCIH2170_HIGH_HER2_R1_G0_2501_37,130,9,121,41,17,21,92,3,130
NCIH2170_TOTAL_HER2_R1_G0_2501_58_Merge.tif (RGB).tif,NCIH2170_TOTAL_HER2_R1_G0_2501_58,286,4,282,86,33,47,206,6,286
NCIH2170_LOW_HER2_R1_G0_2501_99_Merge.tif (RGB).tif,NCIH2170_LOW_HER2_R1_G0_2501_99,155,19,136,47,21,19,115,7,155
NCIH2170_LOW_HER2_R1_G0_2501_35_Merge.tif (RGB).tif,NCIH2170_LOW_HER2_R1_G0_2501_35,185,16,169,48,20,22,143,6,185
NCIH2170_TOTAL_HER2_R1_G1_2404_109_Merge(RGB).tif,NCIH2170_TOTAL_HER2_R1_G1_2404_109_Merge(RGB),158,2,156,60,33,15,110,12,158
NCIH2170_HIGH_HER2_R1_G2_24_10_110_Merge(RGB).tif,NCIH2170_HIGH_HER2_R1_G2_24_10_110_Merge(RGB),255,1,254,65,35,22,198,8,255
NCIH2170_TOTAL_HER2_R1_G0_2501_46_Merge.tif (RGB).tif,NCIH2170_TOTAL_HER2_R1_G0_2501_46,198,0,198,58,20,36,142,2,198
NCIH2170_TOTAL_HER2_R1_G0_2501_77_Merge.tif (RGB).tif,NCIH2170_TOTAL_HER2_R1_G0_2501_77,180,5,175,49,23,22,135,4,180
NCIH2170_LOW_HER2_R1_G0_2501_32_Merge.tif (RGB).tif,NCIH2170_LOW_HER2_R1_G0_2501_32,67,7,60,34,18,7,42,9,67
NCIH2170_LOW_HER2_R1_G2_24_10_115_Merge(RGB).tif,NCIH2170_LOW_HER2_R1_G2_24_10_115_Merge(RGB),182,6,176,52,27,23,132,2,182
NCIH2170_HIGH_HER2_R1_G1_2404_S2_63_Merge(RGB).tif,NCIH2170_HIGH_HER2_R1_G1_2404_S2_63_Merge(RGB),95,3,92,46,18,16,61,12,95
NCIH2170_LOW_HER2_R1_G0_2501_7_Merge.tif (RGB).tif,NCIH2170_LOW_HER2_R1_G0_2501_7,54,1,53,117,1,29,24,87,54
NCIH2170_TOTAL_HER2_R1_G1_2404_49_Merge(RGB).tif,NCIH2170_TOTAL_HER2_R1_G1_2404_49_Merge(RGB),426,0,426,223,72,68,286,83,426
NCIH2170_TOTAL_HER2_R1_G0_2501_82_Merge.tif (RGB).tif,NCIH2170_TOTAL_HER2_R1_G0_2501_82,132,0,132,49,24,21,87,4,132
NCIH2170_LOW_HER2_R1_G2_24_10_33_Merge(RGB).tif,NCIH2170_LOW_HER2_R1_G2_24_10_33_Merge(RGB),230,23,207,45,13,22,195,10,230
NCIH2170_HIGH_HER2_R1_G0_2501_41_Merge.tif (RGB).tif,NCIH2170_HIGH_HER2_R1_G0_2501_41,116,2,114,24,7,13,96,4,116
NCIH2170_HIGH_HER2_R1_G2_24_10_72_Merge(RGB).tif,NCIH2170_HIGH_HER2_R1_G2_24_10_72_Merge(RGB),434,19,415,112,79,26,329,7,434
NCIH2170_TOTAL_HER2_R1_G0_2501_40_Merge.tif (RGB).tif,NCIH2170_TOTAL_HER2_R1_G0_2501_40,236,19,217,36,15,20,201,1,236
NCIH2170_HIGH_HER2_R1_G1_2404_S2_114_Merge(RGB).tif,NCIH2170_HIGH_HER2_R1_G1_2404_S2_114_Merge(RGB),163,0,163,167,90,24,49,53,163
NCIH2170_HIGH_HER2_R1_G2_24_10_129_Merge(RGB).tif,NCIH2170_HIGH_HER2_R1_G2_24_10_129_Merge(RGB),132,10,122,59,28,24,80,7,132
NCIH2170_TOTAL_HER2_R1_G1_2404_16_Merge(RGB).tif,NCIH2170_TOTAL_HER2_R1_G1_2404_16_Merge(RGB),463,2,461,227,115,72,276,40,463
NCIH2170_HIGH_HER2_R1_G2_24_10_90_Merge(RGB).tif,NCIH2170_HIGH_HER2_R1_G2_24_10_90_Merge(RGB),196,13,183,83,50,24,122,9,196
NCIH2170_TOTAL_HER2_R1_G1_2404_68_Merge(RGB).tif,NCIH2170_TOTAL_HER2_R1_G1_2404_68_Merge(RGB),151,25,126,66,39,18,94,9,151
NCIH2170_LOW_HER2_R1_G0_2501_37_Merge.tif (RGB).tif,NCIH2170_LOW_HER2_R1_G0_2501_37,36,5,31,11,4,2,30,5,36
NCIH2170_TOTAL_HER2_R1_G1_2404_64_Merge(RGB).tif,NCIH2170_TOTAL_HER2_R1_G1_2404_64_Merge(RGB),200,32,168,114,60,26,114,28,200
NCIH2170_LOW_HER2_R1_G2_24_10_105_Merge(RGB).tif,NCIH2170_LOW_HER2_R1_G2_24_10_105_Merge(RGB),148,36,112,52,19,22,107,11,148
NCIH2170_HIGH_HER2_R1_G1_2404_S2_117_Merge(RGB).tif,NCIH2170_HIGH_HER2_R1_G1_2404_S2_117_Merge(RGB),145,26,119,80,23,31,91,26,145
NCIH2170_LOW_HER2_R1_G2_24_10_43_Merge(RGB).tif,NCIH2170_LOW_HER2_R1_G2_24_10_43_Merge(RGB),84,10,74,38,22,10,52,6,84
NCIH2170_TOTAL_HER2_R1_G2_24_10_80_Merge(RGB).tif,NCIH2170_TOTAL_HER2_R1_G2_24_10_80_Merge(RGB),387,2,385,103,55,43,289,5,387
NCIH2170_TOTAL_HER2_R1_G2_24_10_42_Merge(RGB).tif,NCIH2170_TOTAL_HER2_R1_G2_24_10_42_Merge(RGB),119,12,107,25,16,7,96,2,119
NCIH2170_TOTAL_HER2_R1_G1_2404_92_Merge(RGB).tif,NCIH2170_TOTAL_HER2_R1_G1_2404_92_Merge(RGB),196,9,187,88,54,32,110,2,196
NCIH2170_TOTAL_HER2_R1_G1_2404_113_Merge(RGB).tif,NCIH2170_TOTAL_HER2_R1_G1_2404_113_Merge(RGB),179,0,179,99,54,17,108,28,179
NCIH2170_TOTAL_HER2_R1_G0_2501_39_Merge.tif (RGB).tif,NCIH2170_TOTAL_HER2_R1_G0_2501_39,139,1,138,54,29,20,90,5,139
NCIH2170_HIGH_HER2_R1_G2_24_10_85_Merge(RGB).tif,NCIH2170_HIGH_HER2_R1_G2_24_10_85_Merge(RGB),231,2,229,71,39,24,168,8,231
NCIH2170_TOTAL_HER2_R1_G2_24_10_5_Merge(RGB).tif,NCIH2170_TOTAL_HER2_R1_G2_24_10_5_Merge(RGB),181,5,176,139,50,45,86,44,181
NCIH2170_LOW_HER2_R1_G2_24_10_46_Merge(RGB).tif,NCIH2170_LOW_HER2_R1_G2_24_10_46_Merge(RGB),178,8,170,64,30,26,122,8,178
NCIH2170_TOTAL_HER2_R1_G0_2501_6_Merge.tif (RGB).tif,NCIH2170_TOTAL_HER2_R1_G0_2501_6,145,8,137,57,0,37,108,20,145
NCIH2170_HIGH_HER2_R1_G2_24_10_67_Merge(RGB).tif,NCIH2170_HIGH_HER2_R1_G2_24_10_67_Merge(RGB),339,5,334,99,50,38,251,11,339
NCIH2170_HIGH_HER2_R1_G1_2404_S2_91_Merge(RGB).tif,NCIH2170_HIGH_HER2_R1_G1_2404_S2_91_Merge(RGB),59,0,59,79,21,21,17,37,59
NCIH2170_HIGH_HER2_R1_G2_24_10_109_Merge(RGB).tif,NCIH2170_HIGH_HER2_R1_G2_24_10_109_Merge(RGB),177,11,166,72,26,30,121,16,177
NCIH2170_LOW_HER2_R1_G0_2501_46_Merge.tif (RGB).tif,NCIH2170_LOW_HER2_R1_G0_2501_46,194,8,186,55,19,34,141,2,194
NCIH2170_TOTAL_HER2_R1_G0_2501_74_Merge.tif (RGB).tif,NCIH2170_TOTAL_HER2_R1_G0_2501_74,142,0,142,49,12,27,103,10,142
NCIH2170_TOTAL_HER2_R1_G0_2501_127_Merge.tif (RGB).tif,NCIH2170_TOTAL_HER2_R1_G0_2501_127,107,0,107,38,13,18,76,7,107
NCIH2170_HIGH_HER2_R1_G2_24_10_82B_Merge(RGB).tif,NCIH2170_HIGH_HER2_R1_G2_24_10_82B_Merge(RGB),214,4,210,81,56,14,144,11,214
NCIH2170_HIGH_HER2_R1_G0_2501_8_Merge.tif (RGB).tif,NCIH2170_HIGH_HER2_R1_G0_2501_8,76,3,73,32,0,8,68,24,76
NCIH2170_TOTAL_HER2_R1_G2_24_10_30_Merge(RGB).tif,NCIH2170_TOTAL_HER2_R1_G2_24_10_30_Merge(RGB),39,5,34,54,12,7,20,35,39
NCIH2170_TOTAL_HER2_R1_G2_24_10_16_Merge(RGB).tif,NCIH2170_TOTAL_HER2_R1_G2_24_10_16_Merge(RGB),290,11,279,138,41,47,202,50,290
NCIH2170_HIGH_HER2_R1_G1_2404_S2_64_Merge(RGB).tif,NCIH2170_HIGH_HER2_R1_G1_2404_S2_64_Merge(RGB),174,0,174,119,40,52,82,27,174
NCIH2170_TOTAL_HER2_R1_G2_24_10_17_Merge(RGB).tif,NCIH2170_TOTAL_HER2_R1_G2_24_10_17_Merge(RGB),114,3,111,56,21,23,70,12,114
NCIH2170_HIGH_HER2_R1_G0_2501_29_Merge.tif (RGB).tif,NCIH2170_HIGH_HER2_R1_G0_2501_29,262,15,247,83,23,44,195,16,262
NCIH2170_HIGH_HER2_R1_G1_2404_S2_121_Merge(RGB).tif,NCIH2170_HIGH_HER2_R1_G1_2404_S2_121_Merge(RGB),210,0,210,163,104,34,72,25,210
NCIH2170_TOTAL_HER2_R1_G1_2404_72_Merge(RGB).tif,NCIH2170_TOTAL_HER2_R1_G1_2404_72_Merge(RGB),227,7,220,226,88,48,91,90,227
NCIH2170_LOW_HER2_R1_G2_24_10_130_Merge(RGB).tif,NCIH2170_LOW_HER2_R1_G2_24_10_130_Merge(RGB),142,41,101,30,12,14,116,4,142
NCIH2170_LOW_HER2_R1_G1_2404_71_Merge(RGB).tif,NCIH2170_LOW_HER2_R1_G1_2404_71_Merge(RGB),111,3,108,96,49,21,41,26,111
NCIH2170_HIGH_HER2_R1_G2_24_10_44_Merge(RGB).tif,NCIH2170_HIGH_HER2_R1_G2_24_10_44_Merge(RGB),214,6,208,184,101,37,76,46,214
NCIH2170_LOW_HER2_R1_G1_2404_26_Merge(RGB).tif,NCIH2170_LOW_HER2_R1_G1_2404_26_Merge(RGB),308,25,283,153,59,46,203,48,308
NCIH2170_LOW_HER2_R1_G2_24_10_79_Merge(RGB).tif,NCIH2170_LOW_HER2_R1_G2_24_10_79_Merge(RGB),330,9,321,121,77,29,224,15,330
NCIH2170_LOW_HER2_R1_G2_24_10_20_Merge(RGB).tif,NCIH2170_LOW_HER2_R1_G2_24_10_20_Merge(RGB),640,7,633,173,76,80,484,17,640
NCIH2170_HIGH_HER2_R1_G1_2404_S2_78_Merge(RGB).tif,NCIH2170_HIGH_HER2_R1_G1_2404_S2_78_Merge(RGB),109,6,103,35,25,8,76,2,109
NCIH2170_HIGH_HER2_R1_G1_2404_S2_105_Merge(RGB).tif,NCIH2170_HIGH_HER2_R1_G1_2404_S2_105_Merge(RGB),304,0,304,81,53,23,228,5,304
NCIH2170_LOW_HER2_R1_G1_2404_31_Merge(RGB).tif,NCIH2170_LOW_HER2_R1_G1_2404_31_Merge(RGB),64,0,64,49,14,17,33,18,64
NCIH2170_HIGH_HER2_R1_G1_2404_S2_17_Merge(RGB).tif,NCIH2170_HIGH_HER2_R1_G1_2404_S2_17_Merge(RGB),67,8,59,7,6,1,60,0,67
NCIH2170_TOTAL_HER2_R1_G1_2404_93_Merge(RGB).tif,NCIH2170_TOTAL_HER2_R1_G1_2404_93_Merge(RGB),131,1,130,67,29,27,75,11,131
NCIH2170_HIGH_HER2_R1_G0_2501_99_Merge.tif (RGB).tif,NCIH2170_HIGH_HER2_R1_G0_2501_99,218,3,215,57,26,22,170,9,218
NCIH2170_TOTAL_HER2_R1_G1_2404_116_Merge(RGB).tif,NCIH2170_TOTAL_HER2_R1_G1_2404_116_Merge(RGB),185,0,185,242,87,44,54,111,185
NCIH2170_TOTAL_HER2_R1_G2_24_10_3_Merge(RGB).tif,NCIH2170_TOTAL_HER2_R1_G2_24_10_3_Merge(RGB),256,15,241,69,45,20,191,4,256
NCIH2170_HIGH_HER2_R1_G2_24_10_4_Merge(RGB).tif,NCIH2170_HIGH_HER2_R1_G2_24_10_4_Merge(RGB),123,10,113,27,21,6,96,0,123
NCIH2170_HIGH_HER2_R1_G0_2501_130_Merge.tif (RGB).tif,NCIH2170_HIGH_HER2_R1_G0_2501_130,133,0,133,75,18,37,78,20,133
NCIH2170_TOTAL_HER2_R1_G2_24_10_121_Merge(RGB).tif,NCIH2170_TOTAL_HER2_R1_G2_24_10_121_Merge(RGB),639,0,639,136,54,64,521,18,639
NCIH2170_HIGH_HER2_R1_G1_2404_S2_87_Merge(RGB).tif,NCIH2170_HIGH_HER2_R1_G1_2404_S2_87_Merge(RGB),395,7,388,169,111,44,240,14,395
NCIH2170_LOW_HER2_R1_G0_2501_47_Merge.tif (RGB).tif,NCIH2170_LOW_HER2_R1_G0_2501_47,88,1,87,29,14,10,64,5,88
NCIH2170_LOW_HER2_R1_G0_2501_38_Merge.tif (RGB).tif,NCIH2170_LOW_HER2_R1_G0_2501_38,79,20,59,16,9,5,65,2,79
NCIH2170_HIGH_HER2_R1_G2_24_10_10_Merge(RGB).tif,NCIH2170_HIGH_HER2_R1_G2_24_10_10_Merge(RGB),649,32,617,133,73,41,535,19,649
NCIH2170_LOW_HER2_R1_G2_24_10_4_Merge(RGB).tif,NCIH2170_LOW_HER2_R1_G2_24_10_4_Merge(RGB),165,0,165,80,36,26,103,18,165
NCIH2170_HIGH_HER2_R1_G1_2404_S2_39_Merge(RGB).tif,NCIH2170_HIGH_HER2_R1_G1_2404_S2_39_Merge(RGB),454,76,378,70,39,27,388,4,454
NCIH2170_LOW_HER2_R1_G0_2501_110_Merge.tif (RGB).tif,NCIH2170_LOW_HER2_R1_G0_2501_110,44,5,39,25,3,11,30,11,44
NCIH2170_HIGH_HER2_R1_G2_24_10_8_Merge(RGB).tif,NCIH2170_HIGH_HER2_R1_G2_24_10_8_Merge(RGB),648,16,632,195,105,73,470,17,648
NCIH2170_TOTAL_HER2_R1_G1_2404_122_Merge(RGB).tif,NCIH2170_TOTAL_HER2_R1_G1_2404_122_Merge(RGB),275,29,246,145,82,46,147,17,275
NCIH2170_LOW_HER2_R1_G2_24_10_44_Merge(RGB).tif,NCIH2170_LOW_HER2_R1_G2_24_10_44_Merge(RGB),221,1,220,77,48,20,153,9,221
NCIH2170_HIGH_HER2_R1_G0_2501_40_Merge.tif (RGB).tif,NCIH2170_HIGH_HER2_R1_G0_2501_40,196,13,183,81,38,32,126,11,196
NCIH2170_HIGH_HER2_R1_G0_2501_35_Merge.tif (RGB).tif,NCIH2170_HIGH_HER2_R1_G0_2501_35,128,1,127,31,17,14,97,0,128
NCIH2170_LOW_HER2_R1_G0_2501_55_Merge.tif (RGB).tif,NCIH2170_LOW_HER2_R1_G0_2501_55,172,3,169,72,29,36,107,7,172
NCIH2170_TOTAL_HER2_R1_G1_2404_59_Merge(RGB).tif,NCIH2170_TOTAL_HER2_R1_G1_2404_59_Merge(RGB),189,1,188,67,41,15,133,11,189
NCIH2170_LOW_HER2_R1_G2_24_10_89_Merge(RGB).tif,NCIH2170_LOW_HER2_R1_G2_24_10_89_Merge(RGB),352,1,351,107,40,55,257,12,352
NCIH2170_LOW_HER2_R1_G2_24_10_108_Merge(RGB).tif,NCIH2170_LOW_HER2_R1_G2_24_10_108_Merge(RGB),121,5,116,76,43,18,60,15,121
NCIH2170_LOW_HER2_R1_G1_2404_28_Merge(RGB).tif,NCIH2170_LOW_HER2_R1_G1_2404_28_Merge(RGB),94,0,94,38,23,10,61,5,94
NCIH2170_TOTAL_HER2_R1_G0_2501_95_Merge.tif (RGB).tif,NCIH2170_TOTAL_HER2_R1_G0_2501_95,282,0,282,114,53,52,177,9,282
NCIH2170_LOW_HER2_R1_G2_24_10_28_Merge(RGB).tif,NCIH2170_LOW_HER2_R1_G2_24_10_28_Merge(RGB),219,4,215,56,24,19,176,13,219
NCIH2170_TOTAL_HER2_R1_G1_2404_95_Merge(RGB).tif,NCIH2170_TOTAL_HER2_R1_G1_2404_95_Merge(RGB),176,0,176,178,103,24,49,51,176
NCIH2170_TOTAL_HER2_R1_G1_2404_10_Merge(RGB).tif,NCIH2170_TOTAL_HER2_R1_G1_2404_10_Merge(RGB),198,5,193,142,85,28,85,29,198
NCIH2170_LOW_HER2_R1_G2_24_10_97_Merge(RGB).tif,NCIH2170_LOW_HER2_R1_G2_24_10_97_Merge(RGB),110,3,107,50,26,12,72,12,110
NCIH2170_LOW_HER2_R1_G0_2501_127_Merge.tif (RGB).tif,NCIH2170_LOW_HER2_R1_G0_2501_127,105,12,93,15,5,6,94,4,105
NCIH2170_LOW_HER2_R1_G2_24_10_71_Merge(RGB).tif,NCIH2170_LOW_HER2_R1_G2_24_10_71_Merge(RGB),163,0,163,82,45,19,99,18,163
NCIH2170_HIGH_HER2_R1_G0_2501_116_Merge.tif (RGB).tif,NCIH2170_HIGH_HER2_R1_G0_2501_116,217,9,208,97,37,51,129,9,217
NCIH2170_LOW_HER2_R1_G0_2501_15_Merge.tif (RGB).tif,NCIH2170_LOW_HER2_R1_G0_2501_15,177,1,176,42,20,21,136,1,177
NCIH2170_TOTAL_HER2_R1_G1_2404_94_Merge(RGB).tif,NCIH2170_TOTAL_HER2_R1_G1_2404_94_Merge(RGB),105,7,98,85,32,16,57,37,105
NCIH2170_LOW_HER2_R1_G0_2501_111_Merge.tif (RGB).tif,NCIH2170_LOW_HER2_R1_G0_2501_111,188,12,176,42,9,27,152,6,188
NCIH2170_HIGH_HER2_R1_G0_2501_72_Merge.tif (RGB).tif,NCIH2170_HIGH_HER2_R1_G0_2501_72,209,13,196,79,25,45,139,9,209
NCIH2170_HIGH_HER2_R1_G2_24_10_127_Merge(RGB).tif,NCIH2170_HIGH_HER2_R1_G2_24_10_127_Merge(RGB),203,3,200,36,28,8,167,0,203
NCIH2170_HIGH_HER2_R1_G2_24_10_50_Merge(RGB).tif,NCIH2170_HIGH_HER2_R1_G2_24_10_50_Merge(RGB),451,9,442,129,58,54,339,17,451
NCIH2170_HIGH_HER2_R1_G1_2404_S2_62_Merge(RGB).tif,NCIH2170_HIGH_HER2_R1_G1_2404_S2_62_Merge(RGB),217,0,217,91,46,30,141,15,217
NCIH2170_HIGH_HER2_R1_G1_2404_S2_47_Merge(RGB).tif,NCIH2170_HIGH_HER2_R1_G1_2404_S2_47_Merge(RGB),94,1,93,27,12,11,71,4,94
NCIH2170_TOTAL_HER2_R1_G0_2501_16_Merge.tif (RGB).tif,NCIH2170_TOTAL_HER2_R1_G0_2501_16,256,10,246,106,44,42,170,20,256
NCIH2170_HIGH_HER2_R1_G0_2501_82_Merge.tif (RGB).tif,NCIH2170_HIGH_HER2_R1_G0_2501_82,104,6,98,47,20,18,66,9,104
NCIH2170_TOTAL_HER2_R1_G2_24_10_73_Merge(RGB).tif,NCIH2170_TOTAL_HER2_R1_G2_24_10_73_Merge(RGB),485,0,485,255,137,77,271,41,485
NCIH2170_LOW_HER2_R1_G0_2501_59_Merge.tif (RGB).tif,NCIH2170_LOW_HER2_R1_G0_2501_59,94,6,88,25,3,21,70,1,94
NCIH2170_TOTAL_HER2_R1_G1_2404_90_Merge(RGB).tif,NCIH2170_TOTAL_HER2_R1_G1_2404_90_Merge(RGB),258,2,256,202,121,34,103,47,258
NCIH2170_LOW_HER2_R1_G2_24_10_111_Merge(RGB).tif,NCIH2170_LOW_HER2_R1_G2_24_10_111_Merge(RGB),287,1,286,52,32,15,240,5,287
NCIH2170_HIGH_HER2_R1_G0_2501_98_Merge.tif (RGB).tif,NCIH2170_HIGH_HER2_R1_G0_2501_98,169,0,169,55,25,23,121,7,169
NCIH2170_TOTAL_HER2_R1_G0_2501_3_Merge.tif (RGB).tif,NCIH2170_TOTAL_HER2_R1_G0_2501_3,311,5,306,19,0,1,310,18,311
NCIH2170_HIGH_HER2_R1_G1_2404_S2_24_Merge(RGB).tif,NCIH2170_HIGH_HER2_R1_G1_2404_S2_24_Merge(RGB),199,2,197,107,51,25,123,31,199
NCIH2170_HIGH_HER2_R1_G2_24_10_57_Merge(RGB).tif,NCIH2170_HIGH_HER2_R1_G2_24_10_57_Merge(RGB),198,0,198,105,45,26,127,34,198
NCIH2170_LOW_HER2_R1_G2_24_10_83_Merge(RGB).tif,NCIH2170_LOW_HER2_R1_G2_24_10_83_Merge(RGB),145,3,142,73,40,19,86,14,145
NCIH2170_LOW_HER2_R1_G0_2501_84_Merge.tif (RGB).tif,NCIH2170_LOW_HER2_R1_G0_2501_84,115,6,109,30,13,11,91,6,115
NCIH2170_TOTAL_HER2_R1_G0_2501_10_Merge.tif (RGB).tif,NCIH2170_TOTAL_HER2_R1_G0_2501_10,374,14,360,26,1,23,350,2,374
NCIH2170_HIGH_HER2_R1_G2_24_10_64_Merge(RGB).tif,NCIH2170_HIGH_HER2_R1_G2_24_10_64_Merge(RGB),289,16,273,108,37,59,193,12,289
NCIH2170_HIGH_HER2_R1_G0_2501_9_Merge.tif (RGB).tif,NCIH2170_HIGH_HER2_R1_G0_2501_9,111,0,111,100,2,22,87,76,111
NCIH2170_HIGH_HER2_R1_G2_24_10_63_Merge(RGB).tif,NCIH2170_HIGH_HER2_R1_G2_24_10_63_Merge(RGB),293,2,291,199,35,98,160,66,293
NCIH2170_HIGH_HER2_R1_G2_24_10_47_Merge(RGB).tif,NCIH2170_HIGH_HER2_R1_G2_24_10_47_Merge(RGB),399,9,390,154,53,85,261,16,399
NCIH2170_HIGH_HER2_R1_G1_2404_S2_81_Merge(RGB).tif,NCIH2170_HIGH_HER2_R1_G1_2404_S2_81_Merge(RGB),157,0,157,18,12,3,142,3,157
NCIH2170_TOTAL_HER2_R1_G0_2501_21A_Merge.tif (RGB).tif,NCIH2170_TOTAL_HER2_R1_G0_2501_21A,424,0,424,240,72,144,208,24,424
NCIH2170_TOTAL_HER2_R1_G1_2404_86_Merge(RGB).tif,NCIH2170_TOTAL_HER2_R1_G1_2404_86_Merge(RGB),146,3,143,128,60,27,59,41,146
NCIH2170_HIGH_HER2_R1_G2_24_10_45_Merge(RGB).tif,NCIH2170_HIGH_HER2_R1_G2_24_10_45_Merge(RGB),300,10,290,136,73,44,183,19,300
NCIH2170_TOTAL_HER2_R1_G1_2404_99_Merge(RGB).tif,NCIH2170_TOTAL_HER2_R1_G1_2404_99_Merge(RGB),63,6,57,18,14,3,46,1,63
NCIH2170_HIGH_HER2_R1_G1_2404_S2_123_Merge(RGB).tif,NCIH2170_HIGH_HER2_R1_G1_2404_S2_123_Merge(RGB),114,8,106,61,26,20,68,15,114
NCIH2170_LOW_HER2_R1_G2_24_10_78_Merge(RGB).tif,NCIH2170_LOW_HER2_R1_G2_24_10_78_Merge(RGB),141,0,141,42,31,10,100,1,141
NCIH2170_LOW_HER2_R1_G0_2501_25_Merge.tif (RGB).tif,NCIH2170_LOW_HER2_R1_G0_2501_25,189,9,180,72,26,35,128,11,189
NCIH2170_TOTAL_HER2_R1_G1_2404_21_Merge(RGB).tif,NCIH2170_TOTAL_HER2_R1_G1_2404_21_Merge(RGB),195,2,193,144,51,51,93,42,195
NCIH2170_TOTAL_HER2_R1_G2_24_10_103_Merge(RGB).tif,NCIH2170_TOTAL_HER2_R1_G2_24_10_103_Merge(RGB),180,2,178,57,27,18,135,12,180
NCIH2170_LOW_HER2_R1_G2_24_10_57A_Merge(RGB).tif,NCIH2170_LOW_HER2_R1_G2_24_10_57A_Merge(RGB),69,0,69,23,9,9,51,5,69
NCIH2170_TOTAL_HER2_R1_G2_24_10_62_Merge(RGB).tif,NCIH2170_TOTAL_HER2_R1_G2_24_10_62_Merge(RGB),139,0,139,50,28,15,96,7,139
NCIH2170_HIGH_HER2_R1_G1_2404_S2_61_Merge(RGB).tif,NCIH2170_HIGH_HER2_R1_G1_2404_S2_61_Merge(RGB),537,0,537,418,260,91,186,67,537
NCIH2170_TOTAL_HER2_R1_G1_2404_89_Merge(RGB).tif,NCIH2170_TOTAL_HER2_R1_G1_2404_89_Merge(RGB),315,8,307,233,162,34,119,37,315
NCIH2170_LOW_HER2_R1_G1_2404_80_Merge(RGB).tif,NCIH2170_LOW_HER2_R1_G1_2404_80_Merge(RGB),344,5,339,144,82,40,222,22,344
NCIH2170_HIGH_HER2_R1_G2_24_10_52_Merge(RGB).tif,NCIH2170_HIGH_HER2_R1_G2_24_10_52_Merge(RGB),573,54,519,134,70,51,452,13,573
NCIH2170_LOW_HER2_R1_G2_24_10_37_Merge(RGB).tif,NCIH2170_LOW_HER2_R1_G2_24_10_37_Merge(RGB),381,9,372,149,73,58,250,18,381
NCIH2170_LOW_HER2_R1_G1_2404_9_Merge(RGB).tif,NCIH2170_LOW_HER2_R1_G1_2404_9_Merge(RGB),62,0,62,93,16,11,35,66,62
NCIH2170_LOW_HER2_R1_G1_2404_27_Merge(RGB).tif,NCIH2170_LOW_HER2_R1_G1_2404_27_Merge(RGB),232,6,226,184,91,35,106,58,232
NCIH2170_TOTAL_HER2_R1_G2_24_10_51_Merge(RGB).tif,NCIH2170_TOTAL_HER2_R1_G2_24_10_51_Merge(RGB),214,0,214,55,23,28,163,4,214
NCIH2170_HIGH_HER2_R1_G1_2404_S2_89_Merge(RGB).tif,NCIH2170_HIGH_HER2_R1_G1_2404_S2_89_Merge(RGB),96,0,96,59,43,9,44,7,96
NCIH2170_TOTAL_HER2_R1_G0_2501_43_Merge.tif (RGB).tif,NCIH2170_TOTAL_HER2_R1_G0_2501_43,172,12,160,34,10,22,140,2,172
NCIH2170_HIGH_HER2_R1_G1_2404_S2_108_Merge(RGB).tif,NCIH2170_HIGH_HER2_R1_G1_2404_S2_108_Merge(RGB),118,0,118,68,33,16,69,19,118
NCIH2170_TOTAL_HER2_R1_G0_2501_4_Merge.tif (RGB).tif,NCIH2170_TOTAL_HER2_R1_G0_2501_4,123,12,111,12,0,11,112,1,123
NCIH2170_LOW_HER2_R1_G0_2501_34_Merge.tif (RGB).tif,NCIH2170_LOW_HER2_R1_G0_2501_34,65,8,57,27,10,11,44,6,65
NCIH2170_TOTAL_HER2_R1_G2_24_10_20_Merge(RGB).tif,NCIH2170_TOTAL_HER2_R1_G2_24_10_20_Merge(RGB),409,0,409,101,37,49,323,15,409
NCIH2170_TOTAL_HER2_R1_G0_2501_35_Merge.tif (RGB).tif,NCIH2170_TOTAL_HER2_R1_G0_2501_35,189,3,186,56,28,24,137,4,189
NCIH2170_TOTAL_HER2_R1_G2_24_10_55_Merge(RGB).tif,NCIH2170_TOTAL_HER2_R1_G2_24_10_55_Merge(RGB),163,0,163,70,22,21,120,27,163
NCIH2170_TOTAL_HER2_R1_G2_24_10_119_Merge(RGB).tif,NCIH2170_TOTAL_HER2_R1_G2_24_10_119_Merge(RGB),399,1,398,145,63,61,275,21,399
NCIH2170_LOW_HER2_R1_G2_24_10_99B_Merge(RGB).tif,NCIH2170_LOW_HER2_R1_G2_24_10_99B_Merge(RGB),188,10,178,56,21,25,142,10,188
NCIH2170_TOTAL_HER2_R1_G1_2404_17_Merge(RGB).tif,NCIH2170_TOTAL_HER2_R1_G1_2404_17_Merge(RGB),370,0,370,94,34,48,288,12,370
NCIH2170_TOTAL_HER2_R1_G1_2404_80_Merge(RGB).tif,NCIH2170_TOTAL_HER2_R1_G1_2404_80_Merge(RGB),288,3,285,106,35,41,212,30,288
NCIH2170_TOTAL_HER2_R1_G2_24_10_37_Merge(RGB).tif,NCIH2170_TOTAL_HER2_R1_G2_24_10_37_Merge(RGB),390,7,383,93,20,60,310,13,390
NCIH2170_LOW_HER2_R1_G1_2404_13_Merge(RGB).tif,NCIH2170_LOW_HER2_R1_G1_2404_13_Merge(RGB),218,12,206,67,31,23,164,13,218
NCIH2170_HIGH_HER2_R1_G2_24_10_95_Merge(RGB).tif,NCIH2170_HIGH_HER2_R1_G2_24_10_95_Merge(RGB),158,54,104,59,25,27,106,7,158
NCIH2170_HIGH_HER2_R1_G0_2501_53_Merge.tif (RGB).tif,NCIH2170_HIGH_HER2_R1_G0_2501_53,171,16,155,45,23,15,133,7,171
NCIH2170_HIGH_HER2_R1_G2_24_10_74_Merge(RGB).tif,NCIH2170_HIGH_HER2_R1_G2_24_10_74_Merge(RGB),208,18,190,78,28,30,150,20,208
NCIH2170_TOTAL_HER2_R1_G2_24_10_93_Merge(RGB).tif,NCIH2170_TOTAL_HER2_R1_G2_24_10_93_Merge(RGB),391,1,390,179,78,74,239,27,391
NCIH2170_TOTAL_HER2_R1_G1_2404_130_Merge(RGB).tif,NCIH2170_TOTAL_HER2_R1_G1_2404_130_Merge(RGB),203,0,203,151,20,59,124,72,203
NCIH2170_TOTAL_HER2_R1_G0_2501_111_Merge.tif (RGB).tif,NCIH2170_TOTAL_HER2_R1_G0_2501_111,224,3,221,92,48,24,152,20,224
NCIH2170_HIGH_HER2_R1_G0_2501_93_Merge.tif (RGB).tif,NCIH2170_HIGH_HER2_R1_G0_2501_93,61,17,44,50,6,13,42,31,61
NCIH2170_HIGH_HER2_R1_G0_2501_101_Merge.tif (RGB).tif,NCIH2170_HIGH_HER2_R1_G0_2501_101,79,0,79,83,13,29,37,41,79
NCIH2170_LOW_HER2_R1_G0_2501_70_Merge.tif (RGB).tif,NCIH2170_LOW_HER2_R1_G0_2501_70,276,9,267,47,15,27,234,5,276
NCIH2170_LOW_HER2_R1_G0_2501_64_Merge.tif (RGB).tif,NCIH2170_LOW_HER2_R1_G0_2501_64,250,2,248,105,29,68,153,8,250
NCIH2170_HIGH_HER2_R1_G2_24_10_26_Merge(RGB).tif,NCIH2170_HIGH_HER2_R1_G2_24_10_26_Merge(RGB),312,0,312,109,53,41,218,15,312
NCIH2170_LOW_HER2_R1_G0_2501_121_Merge.tif (RGB).tif,NCIH2170_LOW_HER2_R1_G0_2501_121,111,2,109,44,18,19,74,7,111
NCIH2170_LOW_HER2_R1_G1_2404_44_Merge(RGB).tif,NCIH2170_LOW_HER2_R1_G1_2404_44_Merge(RGB),97,2,95,78,47,18,32,13,97
NCIH2170_TOTAL_HER2_R1_G0_2501_17_Merge.tif (RGB).tif,NCIH2170_TOTAL_HER2_R1_G0_2501_17,102,3,99,48,17,20,65,11,102
NCIH2170_HIGH_HER2_R1_G2_24_10_6_Merge(RGB).tif,NCIH2170_HIGH_HER2_R1_G2_24_10_6_Merge(RGB),225,1,224,135,43,54,128,38,225
NCIH2170_TOTAL_HER2_R1_G1_2404_56_Merge(RGB).tif,NCIH2170_TOTAL_HER2_R1_G1_2404_56_Merge(RGB),137,0,137,88,54,12,71,22,137
NCIH2170_TOTAL_HER2_R1_G1_2404_51_Merge(RGB).tif,NCIH2170_TOTAL_HER2_R1_G1_2404_51_Merge(RGB),620,14,606,254,116,110,394,28,620
NCIH2170_TOTAL_HER2_R1_G2_24_10_23_Merge(RGB).tif,NCIH2170_TOTAL_HER2_R1_G2_24_10_23_Merge(RGB),446,2,444,90,46,38,362,6,446
NCIH2170_LOW_HER2_R1_G0_2501_61_Merge.tif (RGB).tif,NCIH2170_LOW_HER2_R1_G0_2501_61,139,16,123,44,11,32,96,1,139
NCIH2170_LOW_HER2_R1_G2_24_10_45_Merge(RGB).tif,NCIH2170_LOW_HER2_R1_G2_24_10_45_Merge(RGB),147,1,146,33,17,12,118,4,147
NCIH2170_LOW_HER2_R1_G2_24_10_51_Merge(RGB).tif,NCIH2170_LOW_HER2_R1_G2_24_10_51_Merge(RGB),223,2,221,43,15,24,184,4,223
NCIH2170_LOW_HER2_R1_G1_2404_30_Merge(RGB).tif,NCIH2170_LOW_HER2_R1_G1_2404_30_Merge(RGB),261,0,261,130,80,36,145,14,261
NCIH2170_HIGH_HER2_R1_G0_2501_14_Merge.tif (RGB).tif,NCIH2170_HIGH_HER2_R1_G0_2501_14,212,2,210,63,12,42,158,9,212
NCIH2170_HIGH_HER2_R1_G1_2404_S2_15_Merge(RGB).tif,NCIH2170_HIGH_HER2_R1_G1_2404_S2_15_Merge(RGB),178,8,170,84,44,21,113,19,178
NCIH2170_HIGH_HER2_R1_G2_24_10_22_Merge(RGB).tif,NCIH2170_HIGH_HER2_R1_G2_24_10_22_Merge(RGB),265,4,261,54,25,19,221,10,265
NCIH2170_HIGH_HER2_R1_G0_2501_88_Merge.tif (RGB).tif,NCIH2170_HIGH_HER2_R1_G0_2501_88,119,0,119,41,21,15,83,5,119
NCIH2170_LOW_HER2_R1_G2_24_10_48_Merge(RGB).tif,NCIH2170_LOW_HER2_R1_G2_24_10_48_Merge(RGB),140,4,136,103,56,26,58,21,140
NCIH2170_HIGH_HER2_R1_G1_2404_S2_90_Merge(RGB).tif,NCIH2170_HIGH_HER2_R1_G1_2404_S2_90_Merge(RGB),123,0,123,82,58,14,51,10,123
NCIH2170_TOTAL_HER2_R1_G1_2404_76_Merge(RGB).tif,NCIH2170_TOTAL_HER2_R1_G1_2404_76_Merge(RGB),219,0,219,102,33,31,155,38,219
NCIH2170_LOW_HER2_R1_G0_2501_44_Merge.tif (RGB).tif,NCIH2170_LOW_HER2_R1_G0_2501_44,48,8,40,11,5,5,38,1,48
NCIH2170_LOW_HER2_R1_G2_24_10_34_Merge(RGB).tif,NCIH2170_LOW_HER2_R1_G2_24_10_34_Merge(RGB),113,1,112,44,22,16,75,6,113
NCIH2170_HIGH_HER2_R1_G0_2501_127_Merge.tif (RGB).tif,NCIH2170_HIGH_HER2_R1_G0_2501_127,103,1,102,34,15,15,73,4,103
NCIH2170_TOTAL_HER2_R1_G2_24_10_100_Merge(RGB).tif,NCIH2170_TOTAL_HER2_R1_G2_24_10_100_Merge(RGB),496,1,495,131,67,54,375,10,496
NCIH2170_HIGH_HER2_R1_G2_24_10_19_Merge(RGB).tif,NCIH2170_HIGH_HER2_R1_G2_24_10_19_Merge(RGB),156,2,154,57,35,14,107,8,156
NCIH2170_HIGH_HER2_R1_G1_2404_S2_28_Merge(RGB).tif,NCIH2170_HIGH_HER2_R1_G1_2404_S2_28_Merge(RGB),218,5,213,80,26,28,164,26,218
NCIH2170_HIGH_HER2_R1_G2_24_10_18B_Merge(RGB).tif,NCIH2170_HIGH_HER2_R1_G2_24_10_18B_Merge(RGB),265,13,252,52,28,14,223,10,265
NCIH2170_HIGH_HER2_R1_G2_24_10_96_Merge(RGB).tif,NCIH2170_HIGH_HER2_R1_G2_24_10_96_Merge(RGB),90,17,73,75,36,23,31,16,90
NCIH2170_TOTAL_HER2_R1_G1_2404_50_Merge(RGB).tif,NCIH2170_TOTAL_HER2_R1_G1_2404_50_Merge(RGB),590,0,590,348,184,119,287,45,590
NCIH2170_HIGH_HER2_R1_G2_24_10_69_Merge(RGB).tif,NCIH2170_HIGH_HER2_R1_G2_24_10_69_Merge(RGB),102,2,100,40,10,24,68,6,102
NCIH2170_HIGH_HER2_R1_G2_24_10_82A_Merge(RGB).tif,NCIH2170_HIGH_HER2_R1_G2_24_10_82A_Merge(RGB),225,10,215,21,10,9,206,2,225
NCIH2170_TOTAL_HER2_R1_G0_2501_69_Merge.tif (RGB).tif,NCIH2170_TOTAL_HER2_R1_G0_2501_69,389,0,389,98,27,66,296,5,389
NCIH2170_TOTAL_HER2_R1_G0_2501_102_Merge.tif (RGB).tif,NCIH2170_TOTAL_HER2_R1_G0_2501_102,240,12,228,50,22,23,195,5,240
NCIH2170_LOW_HER2_R1_G2_24_10_122_Merge(RGB).tif,NCIH2170_LOW_HER2_R1_G2_24_10_122_Merge(RGB),90,9,81,23,8,11,71,4,90
NCIH2170_HIGH_HER2_R1_G2_24_10_12_Merge(RGB).tif,NCIH2170_HIGH_HER2_R1_G2_24_10_12_Merge(RGB),262,9,253,85,53,20,189,12,262
NCIH2170_LOW_HER2_R1_G0_2501_23_Merge.tif (RGB).tif,NCIH2170_LOW_HER2_R1_G0_2501_23,84,5,79,17,5,9,70,3,84
NCIH2170_TOTAL_HER2_R1_G1_2404_71_Merge(RGB).tif,NCIH2170_TOTAL_HER2_R1_G1_2404_71_Merge(RGB),183,0,183,206,107,36,40,63,183
NCIH2170_LOW_HER2_R1_G2_24_10_65_Merge(RGB).tif,NCIH2170_LOW_HER2_R1_G2_24_10_65_Merge(RGB),339,1,338,115,61,36,242,18,339
NCIH2170_TOTAL_HER2_R1_G0_2501_27A_Merge.tif (RGB).tif,NCIH2170_TOTAL_HER2_R1_G0_2501_27A,137,10,127,73,29,28,80,16,137
NCIH2170_HIGH_HER2_R1_G0_2501_52_Merge.tif (RGB).tif,NCIH2170_HIGH_HER2_R1_G0_2501_52,282,24,258,44,11,30,241,3,282
NCIH2170_LOW_HER2_R1_G1_2404_3_Merge(RGB).tif,NCIH2170_LOW_HER2_R1_G1_2404_3_Merge(RGB),57,7,50,8,7,1,49,0,57
NCIH2170_LOW_HER2_R1_G0_2501_63_Merge.tif (RGB).tif,NCIH2170_LOW_HER2_R1_G0_2501_63,139,4,135,67,25,32,82,10,139
NCIH2170_TOTAL_HER2_R1_G2_24_10_69_Merge(RGB).tif,NCIH2170_TOTAL_HER2_R1_G2_24_10_69_Merge(RGB),355,0,355,110,51,43,261,16,355
NCIH2170_HIGH_HER2_R1_G1_2404_S2_37_Merge(RGB).tif,NCIH2170_HIGH_HER2_R1_G1_2404_S2_37_Merge(RGB),371,13,358,111,48,45,278,18,371
NCIH2170_HIGH_HER2_R1_G2_24_10_41_Merge(RGB).tif,NCIH2170_HIGH_HER2_R1_G2_24_10_41_Merge(RGB),313,9,304,95,63,24,226,8,313
NCIH2170_LOW_HER2_R1_G1_2404_65_Merge(RGB).tif,NCIH2170_LOW_HER2_R1_G1_2404_65_Merge(RGB),150,33,117,50,8,12,130,30,150
NCIH2170_LOW_HER2_R1_G2_24_10_74_Merge(RGB).tif,NCIH2170_LOW_HER2_R1_G2_24_10_74_Merge(RGB),63,0,63,47,23,10,30,14,63
NCIH2170_LOW_HER2_R1_G1_2404_55_Merge(RGB).tif,NCIH2170_LOW_HER2_R1_G1_2404_55_Merge(RGB),182,2,180,118,77,24,81,17,182
NCIH2170_TOTAL_HER2_R1_G2_24_10_89_Merge(RGB).tif,NCIH2170_TOTAL_HER2_R1_G2_24_10_89_Merge(RGB),368,0,368,57,21,33,314,3,368
NCIH2170_LOW_HER2_R1_G2_24_10_95_Merge(RGB).tif,NCIH2170_LOW_HER2_R1_G2_24_10_95_Merge(RGB),178,9,169,90,36,38,104,16,178
NCIH2170_TOTAL_HER2_R1_G2_24_10_64_Merge(RGB).tif,NCIH2170_TOTAL_HER2_R1_G2_24_10_64_Merge(RGB),664,0,664,134,69,56,539,9,664
NCIH2170_TOTAL_HER2_R1_G2_24_10_44_Merge(RGB).tif,NCIH2170_TOTAL_HER2_R1_G2_24_10_44_Merge(RGB),168,2,166,55,22,22,124,11,168
NCIH2170_HIGH_HER2_R1_G2_24_10_112_Merge(RGB).tif,NCIH2170_HIGH_HER2_R1_G2_24_10_112_Merge(RGB),484,4,480,120,63,41,380,16,484
NCIH2170_HIGH_HER2_R1_G2_24_10_89_Merge(RGB).tif,NCIH2170_HIGH_HER2_R1_G2_24_10_89_Merge(RGB),296,8,288,70,21,47,228,2,296
NCIH2170_LOW_HER2_R1_G0_2501_98_Merge.tif (RGB).tif,NCIH2170_LOW_HER2_R1_G0_2501_98,71,7,64,19,13,5,53,1,71
NCIH2170_LOW_HER2_R1_G1_2404_41_Merge(RGB).tif,NCIH2170_LOW_HER2_R1_G1_2404_41_Merge(RGB),200,17,183,51,24,21,155,6,200
NCIH2170_HIGH_HER2_R1_G2_24_10_99_Merge(RGB).tif,NCIH2170_HIGH_HER2_R1_G2_24_10_99_Merge(RGB),77,3,74,77,28,17,32,32,77
NCIH2170_TOTAL_HER2_R1_G2_24_10_115_Merge(RGB).tif,NCIH2170_TOTAL_HER2_R1_G2_24_10_115_Merge(RGB),599,0,599,163,79,60,460,24,599
NCIH2170_TOTAL_HER2_R1_G0_2501_92_Merge.tif (RGB).tif,NCIH2170_TOTAL_HER2_R1_G0_2501_92,190,0,190,61,29,23,138,9,190
NCIH2170_TOTAL_HER2_R1_G0_2501_120_Merge.tif (RGB).tif,NCIH2170_TOTAL_HER2_R1_G0_2501_120,259,0,259,61,20,40,199,1,259
NCIH2170_LOW_HER2_R1_G2_24_10_26_Merge(RGB).tif,NCIH2170_LOW_HER2_R1_G2_24_10_26_Merge(RGB),361,8,353,95,55,33,273,7,361
NCIH2170_TOTAL_HER2_R1_G1_2404_26_Merge(RGB).tif,NCIH2170_TOTAL_HER2_R1_G1_2404_26_Merge(RGB),155,3,152,45,29,13,113,3,155
NCIH2170_TOTAL_HER2_R1_G1_2404_22_Merge(RGB).tif,NCIH2170_TOTAL_HER2_R1_G1_2404_22_Merge(RGB),86,1,85,35,21,8,57,6,86
NCIH2170_TOTAL_HER2_R1_G1_2404_115_Merge(RGB).tif,NCIH2170_TOTAL_HER2_R1_G1_2404_115_Merge(RGB),226,2,224,139,71,32,123,36,226
NCIH2170_HIGH_HER2_R1_G1_2404_S2_98_Merge(RGB).tif,NCIH2170_HIGH_HER2_R1_G1_2404_S2_98_Merge(RGB),296,1,295,85,48,23,225,14,296
NCIH2170_TOTAL_HER2_R1_G1_2404_35_Merge(RGB).tif,NCIH2170_TOTAL_HER2_R1_G1_2404_35_Merge(RGB),68,0,68,27,20,5,43,2,68
NCIH2170_LOW_HER2_R1_G0_2501_119_Merge.tif (RGB).tif,NCIH2170_LOW_HER2_R1_G0_2501_119,120,5,115,54,27,16,77,11,120
NCIH2170_LOW_HER2_R1_G2_24_10_31_Merge(RGB).tif,NCIH2170_LOW_HER2_R1_G2_24_10_31_Merge(RGB),225,9,216,63,49,11,165,3,225
NCIH2170_HIGH_HER2_R1_G1_2404_S2_97_Merge(RGB).tif,NCIH2170_HIGH_HER2_R1_G1_2404_S2_97_Merge(RGB),340,0,340,186,100,50,190,36,340
NCIH2170_TOTAL_HER2_R1_G2_24_10_10_Merge(RGB).tif,NCIH2170_TOTAL_HER2_R1_G2_24_10_10_Merge(RGB),317,6,311,138,36,67,214,35,317
NCIH2170_HIGH_HER2_R1_G1_2404_S2_103_Merge(RGB).tif,NCIH2170_HIGH_HER2_R1_G1_2404_S2_103_Merge(RGB),71,0,71,25,9,14,48,2,71
NCIH2170_TOTAL_HER2_R1_G2_24_10_19_Merge(RGB).tif,NCIH2170_TOTAL_HER2_R1_G2_24_10_19_Merge(RGB),264,1,263,98,59,25,180,14,264
NCIH2170_TOTAL_HER2_R1_G2_24_10_110_Merge(RGB).tif,NCIH2170_TOTAL_HER2_R1_G2_24_10_110_Merge(RGB),367,0,367,88,16,59,292,13,367
NCIH2170_TOTAL_HER2_R1_G0_2501_12_Merge.tif (RGB).tif,NCIH2170_TOTAL_HER2_R1_G0_2501_12,374,17,357,102,2,82,290,18,374
NCIH2170_TOTAL_HER2_R1_G1_2404_103_Merge(RGB).tif,NCIH2170_TOTAL_HER2_R1_G1_2404_103_Merge(RGB),313,2,311,159,101,30,182,28,313
NCIH2170_HIGH_HER2_R1_G2_24_10_21_Merge(RGB).tif,NCIH2170_HIGH_HER2_R1_G2_24_10_21_Merge(RGB),355,6,349,203,112,60,183,31,355
NCIH2170_TOTAL_HER2_R1_G1_2404_128_Merge(RGB).tif,NCIH2170_TOTAL_HER2_R1_G1_2404_128_Merge(RGB),75,2,73,91,26,15,34,50,75
NCIH2170_LOW_HER2_R1_G1_2404_56_Merge(RGB).tif,NCIH2170_LOW_HER2_R1_G1_2404_56_Merge(RGB),67,10,57,21,14,4,49,3,67
NCIH2170_TOTAL_HER2_R1_G1_2404_117_Merge(RGB).tif,NCIH2170_TOTAL_HER2_R1_G1_2404_117_Merge(RGB),364,3,361,174,91,55,218,28,364
NCIH2170_TOTAL_HER2_R1_G0_2501_29_Merge.tif (RGB).tif,NCIH2170_TOTAL_HER2_R1_G0_2501_29,130,4,126,47,21,18,91,8,130
NCIH2170_LOW_HER2_R1_G2_24_10_116_Merge(RGB).tif,NCIH2170_LOW_HER2_R1_G2_24_10_116_Merge(RGB),164,5,159,84,43,28,93,13,164
NCIH2170_LOW_HER2_R1_G1_2404_57_Merge(RGB).tif,NCIH2170_LOW_HER2_R1_G1_2404_57_Merge(RGB),332,0,332,207,95,60,177,52,332
NCIH2170_LOW_HER2_R1_G1_2404_58_Merge(RGB).tif,NCIH2170_LOW_HER2_R1_G1_2404_58_Merge(RGB),542,9,533,145,66,57,419,22,542
NCIH2170_HIGH_HER2_R1_G1_2404_S2_53_Merge(RGB).tif,NCIH2170_HIGH_HER2_R1_G1_2404_S2_53_Merge(RGB),113,3,110,45,17,28,68,0,113
NCIH2170_TOTAL_HER2_R1_G1_2404_25_Merge(RGB).tif,NCIH2170_TOTAL_HER2_R1_G1_2404_25_Merge(RGB),39,2,37,16,9,5,25,2,39
NCIH2170_HIGH_HER2_R1_G2_24_10_111_Merge(RGB).tif,NCIH2170_HIGH_HER2_R1_G2_24_10_111_Merge(RGB),370,22,348,133,37,72,261,24,370
NCIH2170_LOW_HER2_R1_G2_24_10_35_Merge(RGB).tif,NCIH2170_LOW_HER2_R1_G2_24_10_35_Merge(RGB),130,9,121,57,35,10,85,12,130
NCIH2170_HIGH_HER2_R1_G0_2501_10_Merge.tif (RGB).tif,NCIH2170_HIGH_HER2_R1_G0_2501_10,246,0,246,97,0,33,213,64,246
NCIH2170_HIGH_HER2_R1_G2_24_10_13_Merge(RGB).tif,NCIH2170_HIGH_HER2_R1_G2_24_10_13_Merge(RGB),172,1,171,48,33,6,133,9,172
NCIH2170_TOTAL_HER2_R1_G0_2501_44_Merge.tif (RGB).tif,NCIH2170_TOTAL_HER2_R1_G0_2501_44,153,1,152,52,23,23,107,6,153
NCIH2170_HIGH_HER2_R1_G2_24_10_124_Merge(RGB).tif,NCIH2170_HIGH_HER2_R1_G2_24_10_124_Merge(RGB),62,1,61,18,5,5,52,8,62
NCIH2170_LOW_HER2_R1_G2_24_10_87_Merge(RGB).tif,NCIH2170_LOW_HER2_R1_G2_24_10_87_Merge(RGB),289,0,289,117,40,61,188,16,289
NCIH2170_HIGH_HER2_R1_G0_2501_48_Merge.tif (RGB).tif,NCIH2170_HIGH_HER2_R1_G0_2501_48,180,18,162,40,17,18,145,5,180
NCIH2170_TOTAL_HER2_R1_G2_24_10_108_Merge(RGB).tif,NCIH2170_TOTAL_HER2_R1_G2_24_10_108_Merge(RGB),636,7,629,232,117,90,429,25,636
NCIH2170_HIGH_HER2_R1_G2_24_10_71_Merge(RGB).tif,NCIH2170_HIGH_HER2_R1_G2_24_10_71_Merge(RGB),57,16,41,22,11,7,39,4,57
NCIH2170_HIGH_HER2_R1_G2_24_10_113_Merge(RGB).tif,NCIH2170_HIGH_HER2_R1_G2_24_10_113_Merge(RGB),189,1,188,89,23,58,108,8,189
NCIH2170_HIGH_HER2_R1_G2_24_10_43_Merge(RGB).tif,NCIH2170_HIGH_HER2_R1_G2_24_10_43_Merge(RGB),362,7,355,51,30,16,316,5,362
NCIH2170_TOTAL_HER2_R1_G2_24_10_21_Merge(RGB).tif,NCIH2170_TOTAL_HER2_R1_G2_24_10_21_Merge(RGB),298,16,282,60,24,27,247,9,298
NCIH2170_TOTAL_HER2_R1_G0_2501_20_Merge.tif (RGB).tif,NCIH2170_TOTAL_HER2_R1_G0_2501_20,92,0,92,50,16,19,57,15,92
NCIH2170_TOTAL_HER2_R1_G1_2404_38_Merge(RGB).tif,NCIH2170_TOTAL_HER2_R1_G1_2404_38_Merge(RGB),169,0,169,142,78,27,64,37,169
NCIH2170_LOW_HER2_R1_G2_24_10_94_Merge(RGB).tif,NCIH2170_LOW_HER2_R1_G2_24_10_94_Merge(RGB),183,0,183,58,35,23,125,0,183
NCIH2170_TOTAL_HER2_R1_G0_2501_113_Merge.tif (RGB).tif,NCIH2170_TOTAL_HER2_R1_G0_2501_113,178,10,168,42,13,29,136,0,178
NCIH2170_LOW_HER2_R1_G2_24_10_22_Merge(RGB).tif,NCIH2170_LOW_HER2_R1_G2_24_10_22_Merge(RGB),60,5,55,30,18,7,35,5,60
NCIH2170_TOTAL_HER2_R1_G0_2501_30_Merge.tif (RGB).tif,NCIH2170_TOTAL_HER2_R1_G0_2501_30,188,0,188,75,21,47,120,7,188
NCIH2170_LOW_HER2_R1_G0_2501_2_Merge.tif (RGB).tif,NCIH2170_LOW_HER2_R1_G0_2501_2,93,4,89,29,0,4,89,25,93
NCIH2170_TOTAL_HER2_R1_G2_24_10_24_Merge(RGB).tif,NCIH2170_TOTAL_HER2_R1_G2_24_10_24_Merge(RGB),495,0,495,123,56,48,391,19,495
NCIH2170_LOW_HER2_R1_G0_2501_16_Merge.tif (RGB).tif,NCIH2170_LOW_HER2_R1_G0_2501_16,132,3,129,71,24,27,81,20,132
NCIH2170_HIGH_HER2_R1_G1_2404_S2_67_Merge(RGB).tif,NCIH2170_HIGH_HER2_R1_G1_2404_S2_67_Merge(RGB),236,87,149,52,22,27,187,3,236
NCIH2170_HIGH_HER2_R1_G2_24_10_68_Merge(RGB).tif,NCIH2170_HIGH_HER2_R1_G2_24_10_68_Merge(RGB),106,1,105,55,11,29,66,15,106
NCIH2170_LOW_HER2_R1_G0_2501_50_Merge.tif (RGB).tif,NCIH2170_LOW_HER2_R1_G0_2501_50,322,17,305,52,23,26,273,3,322
NCIH2170_LOW_HER2_R1_G1_2404_18_Merge(RGB).tif,NCIH2170_LOW_HER2_R1_G1_2404_18_Merge(RGB),88,3,85,45,19,13,56,13,88
NCIH2170_HIGH_HER2_R1_G2_24_10_54_Merge(RGB).tif,NCIH2170_HIGH_HER2_R1_G2_24_10_54_Merge(RGB),366,16,350,172,65,76,225,31,366
NCIH2170_LOW_HER2_R1_G0_2501_106_Merge.tif (RGB).tif,NCIH2170_LOW_HER2_R1_G0_2501_106,139,11,128,51,15,33,91,3,139
NCIH2170_LOW_HER2_R1_G2_24_10_129_Merge(RGB).tif,NCIH2170_LOW_HER2_R1_G2_24_10_129_Merge(RGB),68,13,55,37,18,9,41,10,68
NCIH2170_HIGH_HER2_R1_G2_24_10_15B_Merge(RGB).tif,NCIH2170_HIGH_HER2_R1_G2_24_10_15B_Merge(RGB),503,13,490,91,53,32,418,6,503
NCIH2170_HIGH_HER2_R1_G0_2501_66_Merge.tif (RGB).tif,NCIH2170_HIGH_HER2_R1_G0_2501_66,94,5,89,12,1,10,83,1,94
NCIH2170_HIGH_HER2_R1_G0_2501_50_Merge.tif (RGB).tif,NCIH2170_HIGH_HER2_R1_G0_2501_50,124,2,122,32,12,18,94,2,124
NCIH2170_TOTAL_HER2_R1_G0_2501_33_Merge.tif (RGB).tif,NCIH2170_TOTAL_HER2_R1_G0_2501_33,183,6,177,61,22,30,131,9,183
NCIH2170_HIGH_HER2_R1_G2_24_10_23_Merge(RGB).tif,NCIH2170_HIGH_HER2_R1_G2_24_10_23_Merge(RGB),418,37,381,126,75,42,301,9,418
NCIH2170_LOW_HER2_R1_G0_2501_26_Merge.tif (RGB).tif,NCIH2170_LOW_HER2_R1_G0_2501_26,91,8,83,50,22,17,52,11,91
NCIH2170_HIGH_HER2_R1_G2_24_10_107_Merge(RGB).tif,NCIH2170_HIGH_HER2_R1_G2_24_10_107_Merge(RGB),243,17,226,70,37,27,179,6,243
NCIH2170_TOTAL_HER2_R1_G0_2501_50_Merge.tif (RGB).tif,NCIH2170_TOTAL_HER2_R1_G0_2501_50,126,6,120,29,7,17,102,5,126
NCIH2170_TOTAL_HER2_R1_G2_24_10_102_Merge(RGB).tif,NCIH2170_TOTAL_HER2_R1_G2_24_10_102_Merge(RGB),308,0,308,91,39,40,229,12,308
NCIH2170_LOW_HER2_R1_G2_24_10_76_Merge(RGB).tif,NCIH2170_LOW_HER2_R1_G2_24_10_76_Merge(RGB),349,0,349,105,49,41,259,15,349
NCIH2170_HIGH_HER2_R1_G0_2501_77_Merge.tif (RGB).tif,NCIH2170_HIGH_HER2_R1_G0_2501_77,89,3,86,29,2,20,67,7,89
NCIH2170_LOW_HER2_R1_G1_2404_69_Merge(RGB).tif,NCIH2170_LOW_HER2_R1_G1_2404_69_Merge(RGB),302,1,301,219,112,54,136,53,302
NCIH2170_HIGH_HER2_R1_G2_24_10_120_Merge(RGB).tif,NCIH2170_HIGH_HER2_R1_G2_24_10_120_Merge(RGB),507,5,502,132,66,54,387,12,507
NCIH2170_TOTAL_HER2_R1_G1_2404_53_Merge(RGB).tif,NCIH2170_TOTAL_HER2_R1_G1_2404_53_Merge(RGB),244,0,244,150,97,22,125,31,244
NCIH2170_LOW_HER2_R1_G0_2501_11_Merge.tif (RGB).tif,NCIH2170_LOW_HER2_R1_G0_2501_11,86,1,85,33,1,12,73,20,86
NCIH2170_TOTAL_HER2_R1_G1_2404_108_Merge(RGB).tif,NCIH2170_TOTAL_HER2_R1_G1_2404_108_Merge(RGB),146,1,145,112,55,20,71,37,146
NCIH2170_TOTAL_HER2_R1_G2_24_10_49_Merge(RGB).tif,NCIH2170_TOTAL_HER2_R1_G2_24_10_49_Merge(RGB),464,3,461,100,45,50,369,5,464
NCIH2170_LOW_HER2_R1_G2_24_10_63_Merge(RGB).tif,NCIH2170_LOW_HER2_R1_G2_24_10_63_Merge(RGB),214,2,212,145,104,25,85,16,214
NCIH2170_HIGH_HER2_R1_G0_2501_20_Merge.tif (RGB).tif,NCIH2170_HIGH_HER2_R1_G0_2501_20,255,20,235,114,62,42,151,10,255
NCIH2170_HIGH_HER2_R1_G0_2501_17_Merge.tif (RGB).tif,NCIH2170_HIGH_HER2_R1_G0_2501_17,148,4,144,37,11,22,115,4,148
NCIH2170_HIGH_HER2_R1_G2_24_10_40_Merge(RGB).tif,NCIH2170_HIGH_HER2_R1_G2_24_10_40_Merge(RGB),256,7,249,45,22,22,212,1,256
NCIH2170_LOW_HER2_R1_G0_2501_107_Merge.tif (RGB).tif,NCIH2170_LOW_HER2_R1_G0_2501_107,281,22,259,96,33,60,188,3,281
NCIH2170_TOTAL_HER2_R1_G0_2501_66_Merge.tif (RGB).tif,NCIH2170_TOTAL_HER2_R1_G0_2501_66,147,0,147,71,20,32,95,19,147
NCIH2170_TOTAL_HER2_R1_G2_24_10_4_Merge(RGB).tif,NCIH2170_TOTAL_HER2_R1_G2_24_10_4_Merge(RGB),92,15,77,50,21,12,59,17,92
NCIH2170_TOTAL_HER2_R1_G0_2501_13_Merge.tif (RGB).tif,NCIH2170_TOTAL_HER2_R1_G0_2501_13,218,8,210,68,29,27,162,12,218
NCIH2170_TOTAL_HER2_R1_G1_2404_3_Merge(RGB).tif,NCIH2170_TOTAL_HER2_R1_G1_2404_3_Merge(RGB),261,0,261,210,107,48,106,55,261
NCIH2170_HIGH_HER2_R1_G1_2404_S2_76_Merge(RGB).tif,NCIH2170_HIGH_HER2_R1_G1_2404_S2_76_Merge(RGB),359,1,358,167,91,53,215,23,359
NCIH2170_TOTAL_HER2_R1_G1_2404_12_Merge(RGB).tif,NCIH2170_TOTAL_HER2_R1_G1_2404_12_Merge(RGB),242,5,237,181,124,32,86,25,242
NCIH2170_TOTAL_HER2_R1_G2_24_10_7_Merge(RGB).tif,NCIH2170_TOTAL_HER2_R1_G2_24_10_7_Merge(RGB),236,4,232,102,47,34,155,21,236
NCIH2170_HIGH_HER2_R1_G1_2404_S2_50_Merge(RGB).tif,NCIH2170_HIGH_HER2_R1_G1_2404_S2_50_Merge(RGB),141,2,139,99,43,26,72,30,141
NCIH2170_HIGH_HER2_R1_G2_24_10_105C_Merge(RGB).tif,NCIH2170_HIGH_HER2_R1_G2_24_10_105C_Merge(RGB),87,1,86,69,12,25,50,32,87
NCIH2170_TOTAL_HER2_R1_G1_2404_11_Merge(RGB).tif,NCIH2170_TOTAL_HER2_R1_G1_2404_11_Merge(RGB),230,22,208,148,60,61,109,27,230
NCIH2170_HIGH_HER2_R1_G1_2404_S2_65_Merge(RGB).tif,NCIH2170_HIGH_HER2_R1_G1_2404_S2_65_Merge(RGB),150,3,147,48,21,15,114,12,150
NCIH2170_HIGH_HER2_R1_G1_2404_S2_77_Merge(RGB).tif,NCIH2170_HIGH_HER2_R1_G1_2404_S2_77_Merge(RGB),218,1,217,127,73,34,111,20,218
NCIH2170_TOTAL_HER2_R1_G0_2501_129_Merge.tif (RGB).tif,NCIH2170_TOTAL_HER2_R1_G0_2501_129,369,0,369,113,44,65,260,4,369
NCIH2170_TOTAL_HER2_R1_G0_2501_65_Merge.tif (RGB).tif,NCIH2170_TOTAL_HER2_R1_G0_2501_65,195,15,180,38,24,11,160,3,195
NCIH2170_TOTAL_HER2_R1_G1_2404_104_Merge(RGB).tif,NCIH2170_TOTAL_HER2_R1_G1_2404_104_Merge(RGB),280,0,280,226,95,49,136,82,280
NCIH2170_TOTAL_HER2_R1_G0_2501_11_Merge.tif (RGB).tif,NCIH2170_TOTAL_HER2_R1_G0_2501_11,245,12,233,64,0,37,208,27,245
NCIH2170_LOW_HER2_R1_G1_2404_48_Merge(RGB).tif,NCIH2170_LOW_HER2_R1_G1_2404_48_Merge(RGB),143,3,140,89,36,39,68,14,143
NCIH2170_HIGH_HER2_R1_G0_2501_91_Merge.tif (RGB).tif,NCIH2170_HIGH_HER2_R1_G0_2501_91,395,11,384,71,27,38,330,6,395
NCIH2170_LOW_HER2_R1_G2_24_10_125_Merge(RGB).tif,NCIH2170_LOW_HER2_R1_G2_24_10_125_Merge(RGB),142,0,142,85,40,29,73,16,142
NCIH2170_TOTAL_HER2_R1_G1_2404_31_Merge(RGB).tif,NCIH2170_TOTAL_HER2_R1_G1_2404_31_Merge(RGB),372,63,309,273,81,130,161,62,372
NCIH2170_HIGH_HER2_R1_G0_2501_90_Merge.tif (RGB).tif,NCIH2170_HIGH_HER2_R1_G0_2501_90,174,4,170,51,25,18,131,8,174
NCIH2170_TOTAL_HER2_R1_G1_2404_60_Merge(RGB).tif,NCIH2170_TOTAL_HER2_R1_G1_2404_60_Merge(RGB),60,0,60,65,27,12,21,26,60
NCIH2170_LOW_HER2_R1_G2_24_10_5_Merge(RGB).tif,NCIH2170_LOW_HER2_R1_G2_24_10_5_Merge(RGB),195,6,189,98,50,36,109,12,195
NCIH2170_HIGH_HER2_R1_G2_24_10_32_Merge(RGB).tif,NCIH2170_HIGH_HER2_R1_G2_24_10_32_Merge(RGB),489,10,479,178,95,61,333,22,489
NCIH2170_HIGH_HER2_R1_G1_2404_S2_130_Merge(RGB).tif,NCIH2170_HIGH_HER2_R1_G1_2404_S2_130_Merge(RGB),369,4,365,136,64,40,265,32,369
NCIH2170_LOW_HER2_R1_G1_2404_59_Merge(RGB).tif,NCIH2170_LOW_HER2_R1_G1_2404_59_Merge(RGB),236,5,231,104,54,38,144,12,236
NCIH2170_TOTAL_HER2_R1_G0_2501_83_Merge.tif (RGB).tif,NCIH2170_TOTAL_HER2_R1_G0_2501_83,288,0,288,55,21,32,235,2,288
NCIH2170_TOTAL_HER2_R1_G0_2501_99_Merge.tif (RGB).tif,NCIH2170_TOTAL_HER2_R1_G0_2501_99,186,3,183,31,13,18,155,0,186
NCIH2170_LOW_HER2_R1_G0_2501_3_Merge.tif (RGB).tif,NCIH2170_LOW_HER2_R1_G0_2501_3,91,2,89,52,1,18,72,33,91
NCIH2170_LOW_HER2_R1_G0_2501_112_Merge.tif (RGB).tif,NCIH2170_LOW_HER2_R1_G0_2501_112,83,5,78,51,19,19,45,13,83
NCIH2170_TOTAL_HER2_R1_G2_24_10_130_Merge(RGB).tif,NCIH2170_TOTAL_HER2_R1_G2_24_10_130_Merge(RGB),165,24,141,125,31,52,82,42,165
NCIH2170_HIGH_HER2_R1_G2_24_10_59_Merge(RGB).tif,NCIH2170_HIGH_HER2_R1_G2_24_10_59_Merge(RGB),350,14,336,86,37,42,271,7,350
NCIH2170_LOW_HER2_R1_G0_2501_79_Merge.tif (RGB).tif,NCIH2170_LOW_HER2_R1_G0_2501_79,61,0,61,25,15,7,39,3,61
NCIH2170_HIGH_HER2_R1_G0_2501_117_Merge.tif (RGB).tif,NCIH2170_HIGH_HER2_R1_G0_2501_117,137,0,137,60,21,28,88,11,137
NCIH2170_HIGH_HER2_R1_G0_2501_34_Merge.tif (RGB).tif,NCIH2170_HIGH_HER2_R1_G0_2501_34,158,4,154,46,17,22,119,7,158
NCIH2170_LOW_HER2_R1_G2_24_10_53_Merge(RGB).tif,NCIH2170_LOW_HER2_R1_G2_24_10_53_Merge(RGB),68,12,56,26,11,13,44,2,68
NCIH2170_TOTAL_HER2_R1_G0_2501_22_Merge.tif (RGB).tif,NCIH2170_TOTAL_HER2_R1_G0_2501_22,174,5,169,65,18,41,115,6,174
NCIH2170_LOW_HER2_R1_G2_24_10_27_Merge(RGB).tif,NCIH2170_LOW_HER2_R1_G2_24_10_27_Merge(RGB),314,1,313,87,42,37,235,8,314
NCIH2170_LOW_HER2_R1_G0_2501_41_Merge.tif (RGB).tif,NCIH2170_LOW_HER2_R1_G0_2501_41,110,9,101,52,14,25,71,13,110
NCIH2170_HIGH_HER2_R1_G1_2404_S2_115_Merge(RGB).tif,NCIH2170_HIGH_HER2_R1_G1_2404_S2_115_Merge(RGB),348,0,348,196,105,54,189,37,348
NCIH2170_HIGH_HER2_R1_G1_2404_S2_126_Merge(RGB).tif,NCIH2170_HIGH_HER2_R1_G1_2404_S2_126_Merge(RGB),179,1,178,72,38,22,119,12,179
NCIH2170_TOTAL_HER2_R1_G0_2501_121_Merge.tif (RGB).tif,NCIH2170_TOTAL_HER2_R1_G0_2501_121,236,0,236,64,23,40,173,1,236
NCIH2170_HIGH_HER2_R1_G1_2404_S2_119_Merge(RGB).tif,NCIH2170_HIGH_HER2_R1_G1_2404_S2_119_Merge(RGB),222,3,219,136,92,24,106,20,222
NCIH2170_HIGH_HER2_R1_G1_2404_S2_18_Merge(RGB).tif,NCIH2170_HIGH_HER2_R1_G1_2404_S2_18_Merge(RGB),207,0,207,119,62,29,116,28,207
NCIH2170_LOW_HER2_R1_G2_24_10_16_Merge(RGB).tif,NCIH2170_LOW_HER2_R1_G2_24_10_16_Merge(RGB),100,1,99,56,23,21,56,12,100
NCIH2170_TOTAL_HER2_R1_G0_2501_125_Merge.tif (RGB).tif,NCIH2170_TOTAL_HER2_R1_G0_2501_125,158,0,158,96,31,34,93,31,158
NCIH2170_LOW_HER2_R1_G0_2501_31B_Merge.tif (RGB).tif,NCIH2170_LOW_HER2_R1_G0_2501_31B,90,4,86,32,13,11,66,8,90
NCIH2170_HIGH_HER2_R1_G0_2501_36_Merge.tif (RGB).tif,NCIH2170_HIGH_HER2_R1_G0_2501_36,127,2,125,35,12,16,99,7,127
NCIH2170_TOTAL_HER2_R1_G2_24_10_90_Merge(RGB).tif,NCIH2170_TOTAL_HER2_R1_G2_24_10_90_Merge(RGB),371,0,371,56,22,31,318,3,371
NCIH2170_TOTAL_HER2_R1_G2_24_10_6_Merge(RGB).tif,NCIH2170_TOTAL_HER2_R1_G2_24_10_6_Merge(RGB),260,12,248,56,27,23,210,6,260
NCIH2170_LOW_HER2_R1_G0_2501_30_Merge.tif (RGB).tif,NCIH2170_LOW_HER2_R1_G0_2501_30,135,1,134,28,17,8,110,3,135
NCIH2170_HIGH_HER2_R1_G2_24_10_25_Merge(RGB).tif,NCIH2170_HIGH_HER2_R1_G2_24_10_25_Merge(RGB),280,11,269,75,39,31,210,5,280
NCIH2170_TOTAL_HER2_R1_G2_24_10_53_Merge(RGB).tif,NCIH2170_TOTAL_HER2_R1_G2_24_10_53_Merge(RGB),335,0,335,146,71,55,209,20,335
NCIH2170_TOTAL_HER2_R1_G2_24_10_77_Merge(RGB).tif,NCIH2170_TOTAL_HER2_R1_G2_24_10_77_Merge(RGB),172,0,172,72,48,19,105,5,172
NCIH2170_LOW_HER2_R1_G2_24_10_11B_Merge(RGB).tif,NCIH2170_LOW_HER2_R1_G2_24_10_11B_Merge(RGB),195,17,178,32,16,14,165,2,195
NCIH2170_HIGH_HER2_R1_G2_24_10_18A_Merge(RGB).tif,NCIH2170_HIGH_HER2_R1_G2_24_10_18A_Merge(RGB),137,0,137,53,21,18,98,14,137
NCIH2170_TOTAL_HER2_R1_G0_2501_93_Merge.tif (RGB).tif,NCIH2170_TOTAL_HER2_R1_G0_2501_93,171,0,171,55,24,18,129,13,171
NCIH2170_TOTAL_HER2_R1_G0_2501_38_Merge.tif (RGB).tif,NCIH2170_TOTAL_HER2_R1_G0_2501_38,191,2,189,68,32,22,137,14,191
NCIH2170_TOTAL_HER2_R1_G1_2404_102_Merge(RGB).tif,NCIH2170_TOTAL_HER2_R1_G1_2404_102_Merge(RGB),235,7,228,197,92,40,103,65,235
NCIH2170_HIGH_HER2_R1_G0_2501_121_Merge.tif (RGB).tif,NCIH2170_HIGH_HER2_R1_G0_2501_121,151,3,148,62,25,29,97,8,151
NCIH2170_TOTAL_HER2_R1_G2_24_10_112_Merge(RGB).tif,NCIH2170_TOTAL_HER2_R1_G2_24_10_112_Merge(RGB),205,3,202,80,33,29,143,18,205
NCIH2170_HIGH_HER2_R1_G0_2501_12_Merge.tif (RGB).tif,NCIH2170_HIGH_HER2_R1_G0_2501_12,170,3,167,52,1,20,149,31,170
NCIH2170_LOW_HER2_R1_G2_24_10_36_Merge(RGB).tif,NCIH2170_LOW_HER2_R1_G2_24_10_36_Merge(RGB),163,14,149,19,2,9,152,8,163
NCIH2170_TOTAL_HER2_R1_G1_2404_37_Merge(RGB).tif,NCIH2170_TOTAL_HER2_R1_G1_2404_37_Merge(RGB),224,25,199,139,74,41,109,24,224
NCIH2170_TOTAL_HER2_R1_G1_2404_32_Merge(RGB).tif,NCIH2170_TOTAL_HER2_R1_G1_2404_32_Merge(RGB),67,0,67,27,4,17,46,6,67
NCIH2170_TOTAL_HER2_R1_G1_2404_19_Merge(RGB).tif,NCIH2170_TOTAL_HER2_R1_G1_2404_19_Merge(RGB),169,7,162,97,44,28,97,25,169
NCIH2170_HIGH_HER2_R1_G0_2501_128_Merge.tif (RGB).tif,NCIH2170_HIGH_HER2_R1_G0_2501_128,139,4,135,24,8,14,117,2,139
NCIH2170_HIGH_HER2_R1_G2_24_10_121_Merge(RGB).tif,NCIH2170_HIGH_HER2_R1_G2_24_10_121_Merge(RGB),222,1,221,89,46,37,139,6,222
NCIH2170_HIGH_HER2_R1_G2_24_10_118_Merge(RGB).tif,NCIH2170_HIGH_HER2_R1_G2_24_10_118_Merge(RGB),172,0,172,88,50,23,99,15,172
NCIH2170_HIGH_HER2_R1_G1_2404_S2_3_Merge(RGB).tif,NCIH2170_HIGH_HER2_R1_G1_2404_S2_3_Merge(RGB),260,4,256,145,98,23,139,24,260
NCIH2170_HIGH_HER2_R1_G2_24_10_108A_Merge(RGB).tif,NCIH2170_HIGH_HER2_R1_G2_24_10_108A_Merge(RGB),183,1,182,67,35,28,120,4,183
NCIH2170_TOTAL_HER2_R1_G0_2501_36_Merge.tif (RGB).tif,NCIH2170_TOTAL_HER2_R1_G0_2501_36,189,0,189,83,52,29,108,2,189
NCIH2170_HIGH_HER2_R1_G1_2404_S2_56_Merge(RGB).tif,NCIH2170_HIGH_HER2_R1_G1_2404_S2_56_Merge(RGB),262,0,262,174,100,53,109,21,262
NCIH2170_TOTAL_HER2_R1_G0_2501_9_Merge.tif (RGB).tif,NCIH2170_TOTAL_HER2_R1_G0_2501_9,211,26,185,56,2,25,184,29,211
NCIH2170_TOTAL_HER2_R1_G2_24_10_101_Merge(RGB).tif,NCIH2170_TOTAL_HER2_R1_G2_24_10_101_Merge(RGB),242,0,242,96,37,34,171,25,242
NCIH2170_HIGH_HER2_R1_G1_2404_S2_54_Merge(RGB).tif,NCIH2170_HIGH_HER2_R1_G1_2404_S2_54_Merge(RGB),124,7,117,65,38,19,67,8,124
NCIH2170_TOTAL_HER2_R1_G1_2404_8_Merge(RGB).tif,NCIH2170_TOTAL_HER2_R1_G1_2404_8_Merge(RGB),41,1,40,23,14,5,22,4,41
NCIH2170_HIGH_HER2_R1_G0_2501_108_Merge.tif (RGB).tif,NCIH2170_HIGH_HER2_R1_G0_2501_108,281,4,277,76,35,29,217,12,281
NCIH2170_TOTAL_HER2_R1_G2_24_10_45_Merge(RGB).tif,NCIH2170_TOTAL_HER2_R1_G2_24_10_45_Merge(RGB),70,5,65,18,14,3,53,1,70
NCIH2170_LOW_HER2_R1_G1_2404_50_Merge(RGB).tif,NCIH2170_LOW_HER2_R1_G1_2404_50_Merge(RGB),154,3,151,62,44,11,99,7,154
NCIH2170_HIGH_HER2_R1_G1_2404_S2_110_Merge(RGB).tif,NCIH2170_HIGH_HER2_R1_G1_2404_S2_110_Merge(RGB),142,35,107,79,40,19,83,20,142
NCIH2170_TOTAL_HER2_R1_G0_2501_124_Merge.tif (RGB).tif,NCIH2170_TOTAL_HER2_R1_G0_2501_124,119,4,115,23,9,11,99,3,119
NCIH2170_TOTAL_HER2_R1_G1_2404_97_Merge(RGB).tif,NCIH2170_TOTAL_HER2_R1_G1_2404_97_Merge(RGB),490,7,483,172,94,67,329,11,490
NCIH2170_HIGH_HER2_R1_G1_2404_S2_69_Merge(RGB).tif,NCIH2170_HIGH_HER2_R1_G1_2404_S2_69_Merge(RGB),125,8,117,50,33,13,79,4,125
NCIH2170_LOW_HER2_R1_G0_2501_76_Merge.tif (RGB).tif,NCIH2170_LOW_HER2_R1_G0_2501_76,86,4,82,35,15,15,56,5,86
NCIH2170_HIGH_HER2_R1_G0_2501_56_Merge.tif (RGB).tif,NCIH2170_HIGH_HER2_R1_G0_2501_56,127,8,119,32,16,12,99,4,127
NCIH2170_TOTAL_HER2_R1_G2_24_10_28_Merge(RGB).tif,NCIH2170_TOTAL_HER2_R1_G2_24_10_28_Merge(RGB),405,22,383,129,37,56,312,36,405
NCIH2170_TOTAL_HER2_R1_G0_2501_88_Merge.tif (RGB).tif,NCIH2170_TOTAL_HER2_R1_G0_2501_88,185,23,162,50,17,30,138,3,185
NCIH2170_HIGH_HER2_R1_G2_24_10_11_Merge(RGB).tif,NCIH2170_HIGH_HER2_R1_G2_24_10_11_Merge(RGB),255,24,231,80,42,26,187,12,255
NCIH2170_LOW_HER2_R1_G2_24_10_23_Merge(RGB).tif,NCIH2170_LOW_HER2_R1_G2_24_10_23_Merge(RGB),223,0,223,92,46,34,143,12,223
NCIH2170_HIGH_HER2_R1_G0_2501_15A_Merge.tif (RGB).tif,NCIH2170_HIGH_HER2_R1_G0_2501_15A,236,3,233,101,29,54,153,18,236
NCIH2170_HIGH_HER2_R1_G2_24_10_122_Merge(RGB).tif,NCIH2170_HIGH_HER2_R1_G2_24_10_122_Merge(RGB),299,2,297,73,33,31,235,9,299
NCIH2170_HIGH_HER2_R1_G0_2501_18_Merge.tif (RGB).tif,NCIH2170_HIGH_HER2_R1_G0_2501_18,113,3,110,36,12,17,84,7,113
NCIH2170_HIGH_HER2_R1_G1_2404_S2_73_Merge(RGB).tif,NCIH2170_HIGH_HER2_R1_G1_2404_S2_73_Merge(RGB),164,19,145,52,31,17,116,4,164
NCIH2170_TOTAL_HER2_R1_G0_2501_23_Merge.tif (RGB).tif,NCIH2170_TOTAL_HER2_R1_G0_2501_23,200,13,187,68,26,35,139,7,200
NCIH2170_HIGH_HER2_R1_G1_2404_S2_75_Merge(RGB).tif,NCIH2170_HIGH_HER2_R1_G1_2404_S2_75_Merge(RGB),325,6,319,117,56,33,236,28,325
NCIH2170_TOTAL_HER2_R1_G1_2404_111_Merge(RGB).tif,NCIH2170_TOTAL_HER2_R1_G1_2404_111_Merge(RGB),202,39,163,135,46,41,115,48,202
NCIH2170_HIGH_HER2_R1_G0_2501_87_Merge.tif (RGB).tif,NCIH2170_HIGH_HER2_R1_G0_2501_87,144,9,135,52,36,15,93,1,144
NCIH2170_HIGH_HER2_R1_G1_2404_S2_32_Merge(RGB).tif,NCIH2170_HIGH_HER2_R1_G1_2404_S2_32_Merge(RGB),395,33,362,108,51,39,305,18,395
NCIH2170_TOTAL_HER2_R1_G0_2501_87_Merge.tif (RGB).tif,NCIH2170_TOTAL_HER2_R1_G0_2501_87,167,1,166,42,16,26,125,0,167
NCIH2170_HIGH_HER2_R1_G1_2404_S2_4_Merge(RGB).tif,NCIH2170_HIGH_HER2_R1_G1_2404_S2_4_Merge(RGB),197,4,193,95,50,32,115,13,197
NCIH2170_LOW_HER2_R1_G1_2404_60_Merge(RGB).tif,NCIH2170_LOW_HER2_R1_G1_2404_60_Merge(RGB),247,18,229,123,49,44,154,30,247
NCIH2170_TOTAL_HER2_R1_G1_2404_83_Merge(RGB).tif,NCIH2170_TOTAL_HER2_R1_G1_2404_83_Merge(RGB),405,18,387,129,93,27,285,9,405
NCIH2170_HIGH_HER2_R1_G1_2404_S2_8_Merge(RGB).tif,NCIH2170_HIGH_HER2_R1_G1_2404_S2_8_Merge(RGB),113,5,108,43,9,18,86,16,113
NCIH2170_TOTAL_HER2_R1_G0_2501_2_Merge.tif (RGB).tif,NCIH2170_TOTAL_HER2_R1_G0_2501_2,63,0,63,88,2,10,51,76,63
NCIH2170_TOTAL_HER2_R1_G2_24_10_40_Merge(RGB).tif,NCIH2170_TOTAL_HER2_R1_G2_24_10_40_Merge(RGB),88,10,78,58,14,23,51,21,88
NCIH2170_HIGH_HER2_R1_G2_24_10_128_Merge(RGB).tif,NCIH2170_HIGH_HER2_R1_G2_24_10_128_Merge(RGB),257,7,250,65,34,28,195,3,257
